concept-academicfield-aircraft	concept:atdate	concept-date-n1941
concept-academicfield-public-health	concept:academicfieldsuchasacademicfield	concept-academicfield-plant-biology
concept-academicfield-public-health	concept:academicprogramatuniversity	concept-university-harvard-school-of-public-health
concept-academicfield-public-health	concept:academicprogramatuniversity	concept-university-uc-berkeley
concept-actor-financial	concept:agentcompeteswithagent	concept-musicartist-times
concept-agent-vision	concept:objectfoundinscene	concept-landscapefeatures-valley
concept-agriculturalproduct-animals	concept:agriculturalproductgrowninlandscapefeatures	concept-landscapefeatures-valley
concept-agriculturalproduct-animals	concept:agriculturalproductincludingagriculturalproduct	concept-meat-beef
concept-agriculturalproduct-banana	concept:agriculturalproductcutintogeometricshape	concept-geometricshape-cubes
concept-agriculturalproduct-beets	concept:agriculturalproductcutintogeometricshape	concept-geometricshape-cubes
concept-agriculturalproduct-bell-pepper	concept:agriculturalproductcookedwithagriculturalproduct	concept-vegetable-garlic
concept-agriculturalproduct-bell-pepper	concept:agriculturalproductcutintogeometricshape	concept-geometricshape-dice
concept-agriculturalproduct-cake	concept:agriculturalproductcutintogeometricshape	concept-geometricshape-cubes
concept-agriculturalproduct-cake	concept:agriculturalproductcutintogeometricshape	concept-geometricshape-squares
concept-agriculturalproduct-cheeses	concept:agriculturalproductcutintogeometricshape	concept-geometricshape-cubes
concept-agriculturalproduct-chives	concept:agriculturalproductcutintogeometricshape	concept-geometricshape-bits
concept-agriculturalproduct-cucumbers	concept:agriculturalproductcutintogeometricshape	concept-geometricshape-cubes
concept-agriculturalproduct-dough	concept:agriculturalproductcutintogeometricshape	concept-geometricshape-squares
concept-agriculturalproduct-eggplants	concept:agriculturalproductcutintogeometricshape	concept-geometricshape-cubes
concept-agriculturalproduct-grape	concept:agriculturalproductcamefromcountry	concept-country---america
concept-agriculturalproduct-green-pepper	concept:agriculturalproductcutintogeometricshape	concept-geometricshape-dice
concept-agriculturalproduct-herbs	concept:agriculturalproductcutintogeometricshape	concept-geometricshape-cubes
concept-agriculturalproduct-lamb	concept:agriculturalproductcutintogeometricshape	concept-geometricshape-cubes
concept-agriculturalproduct-mango	concept:agriculturalproductcutintogeometricshape	concept-geometricshape-cubes
concept-agriculturalproduct-mozzarella	concept:agriculturalproductcutintogeometricshape	concept-geometricshape-cubes
concept-agriculturalproduct-pear	concept:agriculturalproductcutintogeometricshape	concept-geometricshape-cubes
concept-agriculturalproduct-peel	concept:agriculturalproductcutintogeometricshape	concept-geometricshape-cubes
concept-agriculturalproduct-pineapple	concept:agriculturalproductcutintogeometricshape	concept-geometricshape-cubes
concept-agriculturalproduct-red-pepper	concept:agriculturalproductcutintogeometricshape	concept-geometricshape-dice
concept-agriculturalproduct-root	concept:agriculturalproductcamefromcountry	concept-country---america
concept-agriculturalproduct-salt	concept:agriculturalproductcutintogeometricshape	concept-geometricshape-bits
concept-agriculturalproduct-salt	concept:agriculturalproductcutintogeometricshape	concept-geometricshape-cubes
concept-agriculturalproduct-seed	concept:agriculturalproductcutintogeometricshape	concept-geometricshape-cubes
concept-agriculturalproduct-sides	concept:objectfoundinscene	concept-landscapefeatures-valley
concept-agriculturalproduct-skin	concept:agriculturalproductcutintogeometricshape	concept-geometricshape-cubes
concept-agriculturalproduct-tortillas	concept:agriculturalproductcutintogeometricshape	concept-geometricshape-squares
concept-agriculturalproduct-turnip	concept:agriculturalproductcutintogeometricshape	concept-geometricshape-cubes
concept-agriculturalproduct-water	concept:agriculturalproductcutintogeometricshape	concept-geometricshape-cubes
concept-agriculturalproduct-wildflower	concept:agriculturalproductcamefromcountry	concept-country---america
concept-agriculturalproduct-yams	concept:agriculturalproductcutintogeometricshape	concept-geometricshape-cubes
concept-agriculturalproduct-zucchini	concept:agriculturalproductcutintogeometricshape	concept-geometricshape-cubes
concept-airport-minneapolis	concept:proxyfor	concept-stadiumoreventvenue-target-center
concept-amphibian-figures	concept:agentinvolvedwithitem	concept-buildingfeature-window
concept-amphibian-references	concept:agentinvolvedwithitem	concept-buildingfeature-window
concept-animal-commercial-species	concept:animalsuchasfish	concept-fish-swordfish
concept-animal-commercial-species	concept:animalsuchasfish	concept-fish-tuna
concept-animal-deep-sea-fish	concept:animalsuchasfish	concept-fish-swordfish
concept-animal-fatty-fish	concept:animalsuchasfish	concept-fish-mackerel
concept-animal-fatty-fish	concept:animalsuchasfish	concept-fish-tuna
concept-animal-game-species	concept:animalsuchasfish	concept-fish-marlin
concept-animal-hammerheads	concept:animalistypeofanimal	concept-fish-pelagics
concept-animal-large-predator-fish	concept:animalsuchasfish	concept-fish-swordfish
concept-animal-ocean-fish	concept:animalsuchasfish	concept-fish-tuna
concept-animal-pelagic-species	concept:animalsuchasfish	concept-fish-tuna
concept-animal-pelagic-species	concept:animalsuchasfish	concept-fish-whale-sharks
concept-artery-arteries	concept:bodypartcontainsbodypart	concept-bodypart-system001
concept-artery-brain	concept:bodypartcontainsbodypart	concept-artery-arteries
concept-arthropod-files	concept:agentinvolvedwithitem	concept-buildingfeature-window
concept-arthropod-record	concept:agentinvolvedwithitem	concept-buildingfeature-window
concept-astronaut-landing	concept:agentinvolvedwithitem	concept-buildingfeature-window
concept-athlete-aaron	concept:athleteplayssportsteamposition	concept-sportsteamposition-player
concept-athlete-ahman-green	concept:athleteplayssportsteamposition	concept-sportsteamposition-running-back
concept-athlete-andrea-pirlo	concept:athleteplayssportsteamposition	concept-sportsteamposition-player
concept-athlete-andrew-golota	concept:athleteplayssport	concept-sport-boxing
concept-athlete-antonio-margarito	concept:athleteplayssport	concept-sport-boxing
concept-athlete-antonio-pierce	concept:athletehomestadium	concept-stadiumoreventvenue-giants-stadium
concept-athlete-babe-ruth	concept:athleteplayssportsteamposition	concept-sportsteamposition-player
concept-athlete-bernard-hopkins	concept:athleteplayssport	concept-sport-boxing
concept-athlete-blake	concept:athleteinjuredhisbodypart	concept-bone-shoulder
concept-athlete-brad-ausmus-gg	concept:athleteinjuredhisbodypart	concept-braintissue-eyes
concept-athlete-brees	concept:athleteinjuredhisbodypart	concept-bone-shoulder
concept-athlete-brett-farve	concept:athleteplayssportsteamposition	concept-sportsteamposition-player
concept-athlete-calvin-johnson	concept:athleteplayssportsteamposition	concept-sportsteamposition-player
concept-athlete-carmelo-anthony	concept:athleteplayssportsteamposition	concept-sportsteamposition-player
concept-athlete-charles-brewer	concept:athleteinjuredhisbodypart	concept-bone-shoulder
concept-athlete-chris-davis	concept:athletehomestadium	concept-stadiumoreventvenue-giants-stadium
concept-athlete-chris-drury	concept:athletehomestadium	concept-stadiumoreventvenue-giants-stadium
concept-athlete-colton-orr	concept:athletehomestadium	concept-stadiumoreventvenue-giants-stadium
concept-athlete-corey-dillon	concept:athleteplayssportsteamposition	concept-sportsteamposition-running-back
concept-athlete-cristiano-ronaldo	concept:athleteplayssportsteamposition	concept-sportsteamposition-player
concept-athlete-crosby	concept:athleteplayssportsteamposition	concept-sportsteamposition-player
concept-athlete-curtis-martin	concept:athleteplayssportsteamposition	concept-sportsteamposition-player
concept-athlete-curtis-martin	concept:athleteplayssportsteamposition	concept-sportsteamposition-running-back
concept-athlete-damon	concept:athleteinjuredhisbodypart	concept-braintissue-eyes
concept-athlete-dan-marino	concept:athleteplayssportsteamposition	concept-sportsteamposition-player
concept-athlete-danny-wright	concept:athleteplayssportsteamposition	concept-sportsteamposition-player
concept-athlete-david-murphy	concept:athletehomestadium	concept-stadiumoreventvenue-giants-stadium
concept-athlete-derrick-turnbow	concept:athleteplayssportsteamposition	concept-sportsteamposition-player
concept-athlete-dh	concept:athleteinjuredhisbodypart	concept-braintissue-eyes
concept-athlete-diego-corrales	concept:athleteplayssport	concept-sport-boxing
concept-athlete-domenik-hixon	concept:athletehomestadium	concept-stadiumoreventvenue-giants-stadium
concept-athlete-donovan-mcnabb	concept:athleteplayssportsteamposition	concept-sportsteamposition-player
concept-athlete-dwight-lowery	concept:athletehomestadium	concept-stadiumoreventvenue-giants-stadium
concept-athlete-earnest-byner	concept:athleteplayssportsteamposition	concept-sportsteamposition-running-back
concept-athlete-eddie-basinski	concept:athleteplayssportsteamposition	concept-sportsteamposition-player
concept-athlete-eddie-george	concept:athleteplayssportsteamposition	concept-sportsteamposition-running-back
concept-athlete-edgerrin-james	concept:athleteplayssportsteamposition	concept-sportsteamposition-running-back
concept-athlete-eli-manning	concept:athletebeatathlete	concept-athlete-joe-bradley
concept-athlete-emmitt-smith	concept:athleteplayssportsteamposition	concept-sportsteamposition-player
concept-athlete-eric-dickerson	concept:athleteplayssportsteamposition	concept-sportsteamposition-player
concept-athlete-erik-morales	concept:athleteplayssport	concept-sport-boxing
concept-athlete-farve	concept:athletehomestadium	concept-stadiumoreventvenue-giants-stadium
concept-athlete-favre	concept:athleteplayssportsteamposition	concept-sportsteamposition-player
concept-athlete-felix-trinidad	concept:athleteplayssport	concept-sport-boxing
concept-athlete-floyd-mayweather-jr	concept:athleteplayssport	concept-sport-boxing
concept-athlete-frank	concept:athleteplayssportsteamposition	concept-sportsteamposition-player
concept-athlete-fred-mcgriff	concept:athleteplayssportsteamposition	concept-sportsteamposition-player
concept-athlete-freddie-jones	concept:athleteinjuredhisbodypart	concept-braintissue-eyes
concept-athlete-freddie-jones	concept:athleteplayssportsteamposition	concept-sportsteamposition-player
concept-athlete-freeman-mcneil	concept:athleteplayssportsteamposition	concept-sportsteamposition-running-back
concept-athlete-gardner	concept:athleteplayssportsteamposition	concept-sportsteamposition-player
concept-athlete-hasim-rahman	concept:athleteplayssport	concept-sport-boxing
concept-athlete-henrik-lundqvist	concept:athletehomestadium	concept-stadiumoreventvenue-giants-stadium
concept-athlete-henry	concept:athleteplayssportsteamposition	concept-sportsteamposition-player
concept-athlete-html	concept:agentinvolvedwithitem	concept-buildingfeature-window
concept-athlete-jagr	concept:athletehomestadium	concept-stadiumoreventvenue-giants-stadium
concept-athlete-jameer-nelson	concept:athleteinjuredhisbodypart	concept-bone-shoulder
concept-athlete-jaromir-jagr	concept:athletehomestadium	concept-stadiumoreventvenue-giants-stadium
concept-athlete-jason	concept:athleteplayssportsteamposition	concept-sportsteamposition-player
concept-athlete-jeff-lacy	concept:athleteplayssport	concept-sport-boxing
concept-athlete-jerome-bettis	concept:athleteplayssportsteamposition	concept-sportsteamposition-running-back
concept-athlete-jerricho-cotchery	concept:athletehomestadium	concept-stadiumoreventvenue-giants-stadium
concept-athlete-jerry-rice	concept:athleteplayssportsteamposition	concept-sportsteamposition-player
concept-athlete-jim	concept:persondiedatage	2
concept-athlete-jim-brown	concept:athleteplayssportsteamposition	concept-sportsteamposition-running-back
concept-athlete-jim-courier	concept:athletewinsawardtrophytournament	concept-awardtrophytournament-australian-open
concept-athlete-joe-bradley	concept:athleteplayssportsteamposition	concept-sportsteamposition-player
concept-athlete-joe-calzaghe	concept:athleteplayssport	concept-sport-boxing
concept-athlete-joe-namath	concept:athletehomestadium	concept-stadiumoreventvenue-giants-stadium
concept-athlete-john-ruiz	concept:athleteplayssport	concept-sport-boxing
concept-athlete-jones	concept:athleteinjuredhisbodypart	concept-bodypart-hands
concept-athlete-jose-luis-castillo	concept:athleteplayssport	concept-sport-boxing
concept-athlete-juan-manuel-marquez	concept:athleteplayssport	concept-sport-boxing
concept-athlete-junior	concept:athleteinjuredhisbodypart	concept-braintissue-eyes
concept-athlete-kevin	concept:athleteplayssportsteamposition	concept-sportsteamposition-player
concept-athlete-kurt-warner	concept:athleteplayssportsteamposition	concept-sportsteamposition-player
concept-athlete-lawrence-taylor	concept:athletehomestadium	concept-stadiumoreventvenue-giants-stadium
concept-athlete-lawrence-taylor	concept:athleteplayssportsteamposition	concept-sportsteamposition-player
concept-athlete-lindsay-davenport	concept:athletebeatathlete	concept-athlete-williams
concept-athlete-lindsay-davenport	concept:athleteplayssport	concept-sport-tennis
concept-athlete-lleyton-hewitt	concept:athleteplayssport	concept-sport-tennis
concept-athlete-lt--joseph-r--hunt	concept:athleteinjuredhisbodypart	concept-braintissue-eyes
concept-athlete-luis	concept:athleteinjuredhisbodypart	concept-braintissue-eyes
concept-athlete-lundqvist	concept:athletehomestadium	concept-stadiumoreventvenue-giants-stadium
concept-athlete-mac	concept:agentinvolvedwithitem	concept-buildingfeature-windows
concept-athlete-maradona	concept:athleteplayssportsteamposition	concept-sportsteamposition-player
concept-athlete-marc-staal	concept:athletehomestadium	concept-stadiumoreventvenue-giants-stadium
concept-athlete-marco-antonio-barrera	concept:athleteplayssport	concept-sport-boxing
concept-athlete-markus-naslund	concept:athletehomestadium	concept-stadiumoreventvenue-giants-stadium
concept-athlete-michael-strahan	concept:athletehomestadium	concept-stadiumoreventvenue-giants-stadium
concept-athlete-michael-vick	concept:athleteplayssportsteamposition	concept-sportsteamposition-player
concept-athlete-michael-young	concept:athletehomestadium	concept-stadiumoreventvenue-giants-stadium
concept-athlete-miguel-dilone	concept:athleteinjuredhisbodypart	concept-braintissue-eyes
concept-athlete-mike	concept:athleteplayssportsteamposition	concept-sportsteamposition-player
concept-athlete-mike-richter	concept:athletehomestadium	concept-stadiumoreventvenue-giants-stadium
concept-athlete-mike-vick	concept:athleteplayssportsteamposition	concept-sportsteamposition-player
concept-athlete-mikkel-kessler	concept:athleteplayssport	concept-sport-boxing
concept-athlete-nacho-novo	concept:athletehomestadium	concept-stadiumoreventvenue-giants-stadium
concept-athlete-nigel-dawes	concept:athletehomestadium	concept-stadiumoreventvenue-giants-stadium
concept-athlete-o--j--simpson	concept:athleteplayssportsteamposition	concept-sportsteamposition-player
concept-athlete-oscar-de-la-hoya	concept:athleteplayssport	concept-sport-boxing
concept-athlete-osi-umenyiora	concept:athletehomestadium	concept-stadiumoreventvenue-giants-stadium
concept-athlete-ottis-anderson	concept:athleteplayssportsteamposition	concept-sportsteamposition-running-back
concept-athlete-pat-rafter	concept:athleteplayssport	concept-sport-tennis
concept-athlete-paul-mara	concept:athletehomestadium	concept-stadiumoreventvenue-giants-stadium
concept-athlete-pele	concept:athleteplayssportsteamposition	concept-sportsteamposition-player
concept-athlete-pete-sampras	concept:athletebeatathlete	concept-athlete-michael-chang
concept-athlete-pete-sampras	concept:athletewinsawardtrophytournament	concept-awardtrophytournament-australian-open
concept-athlete-petr-prucha	concept:athletehomestadium	concept-stadiumoreventvenue-giants-stadium
concept-athlete-plaxico	concept:athletehomestadium	concept-stadiumoreventvenue-giants-stadium
concept-athlete-randy	concept:athleteplayssportsteamposition	concept-sportsteamposition-player
concept-athlete-randy-foye	concept:athletehomestadium	concept-stadiumoreventvenue-target-center
concept-athlete-ray-allen	concept:athleteinjuredhisbodypart	concept-braintissue-eyes
concept-athlete-reggie-bush	concept:athleteplayssportsteamposition	concept-sportsteamposition-player
concept-athlete-rich-aurilia	concept:athletehomestadium	concept-stadiumoreventvenue-giants-stadium
concept-athlete-ricky-jean-francois	concept:athleteplayssportsteamposition	concept-sportsteamposition-player
concept-athlete-ricky-watters	concept:athleteplayssportsteamposition	concept-sportsteamposition-running-back
concept-athlete-roger-craig	concept:athleteplayssportsteamposition	concept-sportsteamposition-running-back
concept-athlete-ryan-callahan	concept:athletehomestadium	concept-stadiumoreventvenue-giants-stadium
concept-athlete-scott	concept:athleteinjuredhisbodypart	concept-bone-shoulder
concept-athlete-scott-gomez-and-chris-drury	concept:athletehomestadium	concept-stadiumoreventvenue-giants-stadium
concept-athlete-sean-taylor	concept:athleteplayssportsteamposition	concept-sportsteamposition-player
concept-athlete-shane-mosley	concept:athleteplayssport	concept-sport-boxing
concept-athlete-shawntae-spencer	concept:athleteinjuredhisbodypart	concept-braintissue-eyes
concept-athlete-stefan-frei	concept:athletehomestadium	concept-stadiumoreventvenue-giants-stadium
concept-athlete-steve	concept:athleteplayssportsteamposition	concept-sportsteamposition-player
concept-athlete-steve-nash	concept:athleteplayssportsteamposition	concept-sportsteamposition-player
concept-athlete-sugar-ray-leonard	concept:athleteplayssport	concept-sport-boxing
concept-athlete-tiki-barber	concept:athletehomestadium	concept-stadiumoreventvenue-giants-stadium
concept-athlete-tim-tebow	concept:athleteplayssportsteamposition	concept-sportsteamposition-player
concept-athlete-tony-dorsett	concept:athleteplayssportsteamposition	concept-sportsteamposition-running-back
concept-athlete-troy-o-leary	concept:athleteplayssportsteamposition	concept-sportsteamposition-player
concept-athlete-vernon-forrest	concept:athleteplayssport	concept-sport-boxing
concept-athlete-wallace	concept:athleteplayssportsteamposition	concept-sportsteamposition-player
concept-athlete-walter-payton	concept:athleteplayssportsteamposition	concept-sportsteamposition-player
concept-athlete-williams	concept:athleteinjuredhisbodypart	concept-bone-shoulder
concept-athlete-willis	concept:athleteplayssportsteamposition	concept-sportsteamposition-player
concept-athlete-zach-thomas	concept:athleteinjuredhisbodypart	concept-bone-shoulder
concept-attraction-end	concept:objectfoundinscene	concept-landscapefeatures-valley
concept-attraction-grand	concept:riveremptiesintoriver	concept-geopoliticallocation-yosemite
concept-attraction-grand	concept:riveremptiesintoriver	concept-river-colorado-river
concept-attraction-grand	concept:riveremptiesintoriver	concept-river-green-river
concept-attraction-grand	concept:riveremptiesintoriver	concept-river-lake-michigan
concept-attraction-grand	concept:riveremptiesintoriver	concept-river-lee
concept-attraction-grand	concept:riveremptiesintoriver	concept-river-yellowstone
concept-attraction-grand	concept:riveremptiesintoriver	concept-river-zion
concept-attraction-grand	concept:riveremptiesintoriver	concept-skiarea-red-cedar-river
concept-attraction-grand	concept:riveremptiesintoriver	concept-skiarea-snake-river
concept-attraction-mississippi	concept:riveremptiesintoriver	concept-river-great-river-road
concept-attraction-mississippi	concept:riveremptiesintoriver	concept-river-industrial-canal
concept-attraction-mississippi	concept:riveremptiesintoriver	concept-river-intracoastal-waterway
concept-attraction-mississippi	concept:riveremptiesintoriver	concept-river-minnesota-river
concept-attraction-mississippi	concept:riveremptiesintoriver	concept-river-ohio-river
concept-attraction-mississippi	concept:riveremptiesintoriver	concept-river-pacific-coast
concept-attraction-mississippi	concept:riveremptiesintoriver	concept-river-rock-river
concept-attraction-mississippi	concept:riveremptiesintoriver	concept-river-st---croix-river
concept-attraction-mississippi	concept:riveremptiesintoriver	concept-river-st---lawrence-river
concept-attraction-mississippi	concept:riveremptiesintoriver	concept-river-tennessee-river
concept-attraction-mississippi	concept:riveremptiesintoriver	concept-river-yazoo-river
concept-attraction-mouth	concept:objectfoundinscene	concept-landscapefeatures-valley
concept-automobilemaker-abarth	concept:automobilemakerdealersincountry	concept-country-uk
concept-automobilemaker-acura	concept:automobilemakercardealersinstateorprovince	concept-stateorprovince-virginia
concept-automobilemaker-audi	concept:automobilemakerdealersincity	concept-city-san-diego
concept-automobilemaker-audi	concept:hasofficeincountry	concept-country-uk--canada
concept-automobilemaker-bolivia	concept:agentbelongstoorganization	concept-sportsleague-mls
concept-automobilemaker-buick	concept:automakerproducesmodel	concept-automobilemodel-buick-century
concept-automobilemaker-buick	concept:automakerproducesmodel	concept-automobilemodel-buick-rainier
concept-automobilemaker-buick	concept:automakerproducesmodel	concept-automobilemodel-buick-regal
concept-automobilemaker-buick	concept:automakerproducesmodel	concept-automobilemodel-buick-rendezvous
concept-automobilemaker-buick	concept:automakerproducesmodel	concept-automobilemodel-regal
concept-automobilemaker-buick	concept:automakerproducesmodel	concept-automobilemodel-riviera
concept-automobilemaker-buick	concept:automobilemakerdealersincity	concept-city-columbus
concept-automobilemaker-chevrolet	concept:automobilemakerdealersincity	concept-city-baton-rouge
concept-automobilemaker-chevrolet	concept:hasofficeincountry	concept-country-uk
concept-automobilemaker-chrysler	concept:automobilemakerdealersincountry	concept-country-uk
concept-automobilemaker-ferrari	concept:subpartoforganization	concept-automobilemaker-fiat-spa
concept-automobilemaker-fiat	concept:acquired	concept-automobilemaker-ferrari
concept-automobilemaker-fiat	concept:companyeconomicsector	concept-economicsector-auto
concept-automobilemaker-ford	concept:automakerproducesmodel	concept-automobilemodel-edge
concept-automobilemaker-ford	concept:automobilemakerdealersincountry	concept-country-uk
concept-automobilemaker-gm	concept:acquired	concept-automobilemaker-gmc
concept-automobilemaker-gm	concept:acquired	concept-automobilemaker-vauxhall
concept-automobilemaker-honda	concept:agentcreated	concept-automobilemodel-toyota-corolla
concept-automobilemaker-honda	concept:agentcreated	concept-automobilemodel-toyota-prius
concept-automobilemaker-honda	concept:agentcreated	concept-charactertrait-insight
concept-automobilemaker-honda	concept:agentcreated	concept-city-fit
concept-automobilemaker-honda	concept:agentcreated	concept-city-prelude
concept-automobilemaker-honda	concept:agentinvolvedwithitem	concept-automobilemodel-ford-mustang
concept-automobilemaker-honda	concept:agentinvolvedwithitem	concept-automobilemodel-honda-fit
concept-automobilemaker-honda	concept:agentinvolvedwithitem	concept-automobilemodel-nissan-altima
concept-automobilemaker-honda	concept:agentinvolvedwithitem	concept-buildingfeature-fit
concept-automobilemaker-honda	concept:agentinvolvedwithitem	concept-hallwayitem-van
concept-automobilemaker-honda	concept:automakerproducesmodel	concept-automobilemodel-accord
concept-automobilemaker-honda	concept:automakerproducesmodel	concept-automobilemodel-accord-crosstour
concept-automobilemaker-honda	concept:automakerproducesmodel	concept-automobilemodel-civic-coupe
concept-automobilemaker-honda	concept:automakerproducesmodel	concept-automobilemodel-civic-hybrid
concept-automobilemaker-honda	concept:automakerproducesmodel	concept-automobilemodel-civic-si
concept-automobilemaker-honda	concept:automakerproducesmodel	concept-automobilemodel-cr-v
concept-automobilemaker-honda	concept:automakerproducesmodel	concept-automobilemodel-honda-civic
concept-automobilemaker-honda	concept:automakerproducesmodel	concept-automobilemodel-honda-cr-v
concept-automobilemaker-honda	concept:automakerproducesmodel	concept-automobilemodel-honda-odyssey
concept-automobilemaker-honda	concept:automakerproducesmodel	concept-automobilemodel-passport
concept-automobilemaker-honda	concept:automakerproducesmodel	concept-automobilemodel-ridgeline
concept-automobilemaker-honda	concept:automakerproducesmodel	concept-product-crv
concept-automobilemaker-honda	concept:automakerproducesmodel	concept-product-element
concept-automobilemaker-honda	concept:automakerproducesmodel	concept-product-insight
concept-automobilemaker-honda	concept:automobilemakercardealersinstateorprovince	concept-stateorprovince-alabama
concept-automobilemaker-honda	concept:automobilemakercardealersinstateorprovince	concept-stateorprovince-maryland
concept-automobilemaker-honda	concept:automobilemakercardealersinstateorprovince	concept-stateorprovince-oklahoma
concept-automobilemaker-honda	concept:automobilemakerdealersincity	concept-city-albuquerque
concept-automobilemaker-honda	concept:automobilemakerdealersincity	concept-city-athens
concept-automobilemaker-honda	concept:automobilemakerdealersincity	concept-city-bakersfield
concept-automobilemaker-honda	concept:automobilemakerdealersincity	concept-city-fort-worth
concept-automobilemaker-honda	concept:automobilemakerdealersincity	concept-city-houston
concept-automobilemaker-honda	concept:automobilemakerdealersincity	concept-city-huntsville
concept-automobilemaker-honda	concept:automobilemakerdealersincity	concept-city-minneapolis
concept-automobilemaker-honda	concept:automobilemakerdealersincity	concept-city-sacramento
concept-automobilemaker-honda	concept:automobilemakerdealersincity	concept-city-santa-monica
concept-automobilemaker-honda	concept:automobilemakerdealersincity	concept-city-seattle
concept-automobilemaker-honda	concept:automobilemakerdealersincity	concept-city-tulsa
concept-automobilemaker-honda	concept:automobilemakerdealersincity	concept-city-wilmington
concept-automobilemaker-honda	concept:automobilemakerdealersincountry	concept-country-uk
concept-automobilemaker-honda	concept:companyeconomicsector	concept-economicsector-auto
concept-automobilemaker-honda	concept:competeswith	concept-automobilemaker-toyota
concept-automobilemaker-honda	concept:organizationterminatedperson	concept-ceo-takeo-fukui
concept-automobilemaker-honda	concept:producesproduct	concept-automobilemodel-honda-accord
concept-automobilemaker-honda	concept:producesproduct	concept-automobilemodel-odyssey
concept-automobilemaker-honda	concept:producesproduct	concept-product-prelude
concept-automobilemaker-hummer	concept:hasofficeincountry	concept-country-uk
concept-automobilemaker-infiniti	concept:automobilemakercardealersinstateorprovince	concept-stateorprovince-virginia
concept-automobilemaker-jeep	concept:automobilemakerdealersincity	concept-city-charleston
concept-automobilemaker-jeep	concept:automobilemakerdealersincity	concept-city-vancouver
concept-automobilemaker-jeep	concept:hasofficeincountry	concept-country-uk
concept-automobilemaker-jeep	concept:subpartoforganization	concept-automobilemaker-daimlerchrysler
concept-automobilemaker-lancia	concept:hasofficeincountry	concept-country-uk
concept-automobilemaker-land-rover	concept:hasofficeincountry	concept-country-uk
concept-automobilemaker-landrover	concept:automobilemakerdealersincountry	concept-country-uk
concept-automobilemaker-lincoln	concept:automobilemakercardealersinstateorprovince	concept-stateorprovince-virginia
concept-automobilemaker-listing	concept:agentinvolvedwithitem	concept-buildingfeature-window
concept-automobilemaker-maserati	concept:automobilemakerdealersincountry	concept-country---america
concept-automobilemaker-mazda	concept:automobilemakerdealersincountry	concept-country-uk
concept-automobilemaker-mercedes-benz	concept:automobilemakercardealersinstateorprovince	concept-stateorprovince-virginia
concept-automobilemaker-mini	concept:hasofficeincountry	concept-country-uk
concept-automobilemaker-mitsubishi	concept:agentinvolvedwithitem	concept-buildingfeature-eclipse
concept-automobilemaker-mitsubishi	concept:automakerproducesmodel	concept-automobilemodel-colt
concept-automobilemaker-mitsubishi	concept:automakerproducesmodel	concept-automobilemodel-eclipse
concept-automobilemaker-mitsubishi	concept:automakerproducesmodel	concept-automobilemodel-mitsubishi-eclipse
concept-automobilemaker-mitsubishi	concept:automakerproducesmodel	concept-visualizableobject-lancer
concept-automobilemaker-mitsubishi	concept:hasofficeincountry	concept-country-uk
concept-automobilemaker-money	concept:subpartoforganization	concept-terroristorganization-state
concept-automobilemaker-nafta	concept:hasofficeincountry	concept-country---america
concept-automobilemaker-pagani	concept:automobilemakerdealersincountry	concept-country-uk
concept-automobilemaker-partners	concept:subpartoforganization	concept-terroristorganization-state
concept-automobilemaker-porsche	concept:automobilemakerdealersincountry	concept-country-uk
concept-automobilemaker-proton	concept:hasofficeincountry	concept-country-uk
concept-automobilemaker-request	concept:agentinvolvedwithitem	concept-buildingfeature-window
concept-automobilemaker-skoda	concept:hasofficeincountry	concept-country-uk
concept-automobilemaker-smart	concept:automobilemakerdealersincountry	concept-country-uk
concept-automobilemaker-subaru	concept:automakerproducesmodel	concept-automobilemodel-forester
concept-automobilemaker-subaru	concept:automakerproducesmodel	concept-automobilemodel-subaru-forester
concept-automobilemaker-subaru	concept:automakerproducesmodel	concept-automobilemodel-subaru-impreza
concept-automobilemaker-subaru	concept:automakerproducesmodel	concept-automobilemodel-subaru-legacy
concept-automobilemaker-subaru	concept:automakerproducesmodel	concept-automobilemodel-svx
concept-automobilemaker-subaru	concept:automakerproducesmodel	concept-automobilemodel-wrx
concept-automobilemaker-subaru	concept:hasofficeincountry	concept-country-uk--canada
concept-automobilemaker-subaru	concept:producesproduct	concept-automobilemodel-legacy
concept-automobilemaker-suzuki	concept:automobilemakercardealersinstateorprovince	concept-stateorprovince-virginia
concept-automobilemaker-vauxhall	concept:automobilemakerdealersincountry	concept-country-uk
concept-automobilemaker-view	concept:agentinvolvedwithitem	concept-buildingfeature-window
concept-automobilemaker-volkswagen	concept:automobilemakercardealersinstateorprovince	concept-stateorprovince-virginia
concept-automobilemaker-volvo	concept:automobilemakercardealersinstateorprovince	concept-stateorprovince-virginia
concept-automobilemaker-volvo	concept:automobilemakerdealersincountry	concept-country---america
concept-automobilemodel-edge	concept:objectfoundinscene	concept-landscapefeatures-valley
concept-automobilemodel-gateway	concept:objectfoundinscene	concept-landscapefeatures-valley
concept-automobilemodel-svx	concept:latitudelongitude	56.7431100000000,60.8027300000000
concept-awardtrophytournament-australian-open	concept:awardtrophytournamentisthechampionshipgameofthenationalsport	concept-sport-tennis
concept-awardtrophytournament-championships	concept:awardtrophytournamentisthechampionshipgameofthenationalsport	concept-sport-diving
concept-awardtrophytournament-championships	concept:awardtrophytournamentisthechampionshipgameofthenationalsport	concept-sport-lacrosse
concept-awardtrophytournament-championships	concept:awardtrophytournamentisthechampionshipgameofthenationalsport	concept-sport-soccer
concept-awardtrophytournament-french-open	concept:awardtrophytournamentisthechampionshipgameofthenationalsport	concept-sport-tennis
concept-awardtrophytournament-state-championship	concept:awardtrophytournamentisthechampionshipgameofthenationalsport	concept-sport-soccer
concept-awardtrophytournament-state-championships	concept:awardtrophytournamentisthechampionshipgameofthenationalsport	concept-sport-soccer
concept-awardtrophytournament-women	concept:awardtrophytournamentisthechampionshipgameofthenationalsport	concept-sport-soccer
concept-bacteria-bacillus-cereus	concept:bacteriaisthecausativeagentofphysiologicalcondition	concept-disease-food-poisoning
concept-bacteria-clostridium-botulinum	concept:bacteriaisthecausativeagentofphysiologicalcondition	concept-disease-food-poisoning
concept-bacteria-e--coli	concept:bacteriaisthecausativeagentofphysiologicalcondition	concept-disease-food-poisoning
concept-bacteria-listeria	concept:bacteriaisthecausativeagentofphysiologicalcondition	concept-disease-food-poisoning
concept-bacteria-salmonella	concept:bacteriaisthecausativeagentofphysiologicalcondition	concept-disease-food-poisoning
concept-bacteria-salmonella-typhimurium	concept:bacteriaisthecausativeagentofphysiologicalcondition	concept-disease-food-poisoning
concept-bank-administration	concept:agentcontrols	concept-clothing-white
concept-bank-barclays	concept:acquired	concept-organization-lehman
concept-bank-barclays	concept:bankbankincountry	concept-country---america
concept-bank-chase-manhattan	concept:bankbankincountry	concept-country---america
concept-bank-chase-manhattan	concept:companyeconomicsector	concept-economicsector-investment
concept-bank-citi	concept:bankbankincountry	concept-country-uk
concept-bank-citibank	concept:bankbankincountry	concept-country-malaysia
concept-bank-citibank	concept:companyeconomicsector	concept-economicsector-banking
concept-bank-citicorp	concept:hasofficeincountry	concept-country---america
concept-bank-commonwealth	concept:hasofficeincountry	concept-country---america
concept-bank-first-national-bank	concept:companyeconomicsector	concept-economicsector-banking
concept-bank-hsbc	concept:bankbankincountry	concept-country-oman
concept-bank-j-p--morgan-chase	concept:companyeconomicsector	concept-economicsector-investment
concept-bank-j-p--morgan-securities	concept:bankbankincountry	concept-country---america
concept-bank-jp-morgan	concept:hasofficeincountry	concept-country---america
concept-bank-lehman-brothers	concept:companyeconomicsector	concept-economicsector-large-investment
concept-bank-lehman-brothers	concept:companyeconomicsector	concept-economicsector-us-investment
concept-bank-lehman-brothers	concept:subpartoforganization	concept-bank-barclays-global-investors
concept-bank-lloyds-tsb	concept:bankbankincountry	concept-country-uk
concept-bank-national	concept:bankbankincountry	concept-country---america
concept-bank-national	concept:bankbankincountry	concept-country-new-south-wales
concept-bank-national	concept:bankboughtbank	concept-bank-abu-dhabi-commercial-bank
concept-bank-national	concept:bankboughtbank	concept-bank-agricultural
concept-bank-national	concept:bankboughtbank	concept-bank-ahli-united-bank
concept-bank-national	concept:bankboughtbank	concept-bank-barclays-capital
concept-bank-national	concept:bankboughtbank	concept-bank-barclays-global-investors
concept-bank-national	concept:bankboughtbank	concept-bank-deutsche-bank
concept-bank-national	concept:bankboughtbank	concept-bank-export-import-bank-of-india
concept-bank-national	concept:bankboughtbank	concept-bank-fidelity-national
concept-bank-national	concept:bankboughtbank	concept-bank-first-leasing-company-of-india
concept-bank-national	concept:bankboughtbank	concept-bank-franklin-templeton
concept-bank-national	concept:bankboughtbank	concept-bank-hang-seng
concept-bank-national	concept:bankboughtbank	concept-bank-hdfc
concept-bank-national	concept:bankboughtbank	concept-bank-hdfc-bank
concept-bank-national	concept:bankboughtbank	concept-bank-icici-bank
concept-bank-national	concept:bankboughtbank	concept-bank-indusind-bank-limited
concept-bank-national	concept:bankboughtbank	concept-bank-ing-vysya
concept-bank-national	concept:bankboughtbank	concept-bank-ing-vysya-bank
concept-bank-national	concept:bankboughtbank	concept-bank-karnataka-bank-ltd
concept-bank-national	concept:bankboughtbank	concept-bank-punjab-and-maharashtra-co-operative-bank-ltd
concept-bank-national	concept:bankboughtbank	concept-bank-punjab-national-bank
concept-bank-national	concept:bankboughtbank	concept-bank-standard-bank
concept-bank-national	concept:bankboughtbank	concept-bank-state-bank-of-saurashtra
concept-bank-national	concept:bankboughtbank	concept-bank-syndicate-bank
concept-bank-national	concept:bankboughtbank	concept-bank-td
concept-bank-national	concept:bankboughtbank	concept-bank-td-ameritrade
concept-bank-national	concept:bankboughtbank	concept-bank-treasury
concept-bank-national	concept:bankboughtbank	concept-bank-uti
concept-bank-national	concept:bankboughtbank	concept-bank-vijaya-bank
concept-bank-northern-rock	concept:bankbankincountry	concept-country-uk
concept-bank-policy-makers	concept:subpartoforganization	concept-terroristorganization-state
concept-bathroomitem-closet	concept:itemfoundinroom	concept-visualizablething-bedrooms
concept-bathroomitem-closet	concept:itemfoundinroom	concept-visualizablething-large-master-bedroom
concept-bathroomitem-shower-room	concept:itemfoundinroom	concept-visualizablething-bedrooms
concept-bedroomitem-pillow	concept:itemfoundinroom	concept-visualizablething-bedrooms
concept-beverage-features	concept:objectfoundinscene	concept-landscapefeatures-valley
concept-beverage-gelatin	concept:agriculturalproductcutintogeometricshape	concept-geometricshape-cubes
concept-beverage-side	concept:objectfoundinscene	concept-landscapefeatures-valley
concept-beverage-tomato-juice	concept:agriculturalproductcutintogeometricshape	concept-geometricshape-cubes
concept-beverage-vineyards	concept:objectfoundinscene	concept-landscapefeatures-valley
concept-beverage-wine-region	concept:objectfoundinscene	concept-landscapefeatures-valley
concept-biotechcompany-control	concept:agentinvolvedwithitem	concept-buildingfeature-window
concept-biotechcompany-left	concept:agentinvolvedwithitem	concept-buildingfeature-window
concept-biotechcompany-portugal	concept:hasofficeincountry	concept-country---america
concept-biotechcompany-toronto	concept:proxyfor	concept-company-canada
concept-bird-condor	concept:agentactsinlocation	concept-city-madrid
concept-bird-may	concept:atdate	concept-date-community
concept-blog-george-w--bush	concept:agentcollaborateswithagent	concept-criminal-gore
concept-blog-george-w--bush	concept:agentcollaborateswithagent	concept-geopoliticallocation-kerry
concept-blog-george-w--bush	concept:agentcontrols	concept-clothing-white
concept-blog-george-w--bush	concept:agentcreated	concept-book-decision-points
concept-blog-kfyr-tv	concept:subpartof	concept-retailstore-nbc
concept-blog-komu-tv	concept:subpartof	concept-retailstore-nbc
concept-blog-ksnf	concept:subpartof	concept-retailstore-nbc
concept-blog-wjac-tv	concept:subpartof	concept-retailstore-nbc
concept-boardgame-civil-war	concept:atdate	concept-year-n1865
concept-bodypart-system002	concept:bodypartcontainsbodypart	concept-braintissue-eyes
concept-bodypart-tract001	concept:bodypartcontainsbodypart	concept-braintissue-eyes
concept-book-fall	concept:atdate	concept-date-meeting
concept-book-one-day	concept:atdate	concept-date-n1941
concept-braintissue-eyes	concept:bodypartcontainsbodypart	concept-artery-brain
concept-building-jackson	concept:buildinglocatedincity	concept-city-port-moresby
concept-buildingfeature-closets	concept:itemfoundinroom	concept-officebuildingroom-large-bedrooms
concept-buildingfeature-closets	concept:itemfoundinroom	concept-visualizablething-bedrooms
concept-buildingfeature-systems	concept:subpartof	concept-visualizableobject-home
concept-buildingfeature-windows	concept:synonymfor	concept-museum-microsoft-corporation
concept-candy-value	concept:objectfoundinscene	concept-landscapefeatures-valley
concept-celebrity-aung-san-suu-kyi	concept:personhasjobposition	concept-jobposition-leader
concept-celebrity-illustration	concept:agentinvolvedwithitem	concept-buildingfeature-window
concept-celebrity-screen	concept:agentinvolvedwithitem	concept-buildingfeature-window
concept-celebrity-show	concept:agentinvolvedwithitem	concept-buildingfeature-window
concept-celebrity-spring	concept:atdate	concept-date-meeting
concept-ceo-blogs	concept:agentinvolvedwithitem	concept-buildingfeature-window
concept-ceo-dick-fuld	concept:ceoof	concept-bank-lehman-brothers
concept-ceo-dick-fuld	concept:personleadsorganization	concept-organization-lehman
concept-ceo-home-page-this-page	concept:agentcollaborateswithagent	concept-musicartist-times
concept-ceo-merrill	concept:agentbelongstoorganization	concept-country---america
concept-ceo-randall-l--stephenson	concept:topmemberoforganization	concept-company-at-t
concept-ceo-webpage	concept:agentinvolvedwithitem	concept-buildingfeature-window
concept-charactertrait-fighting	concept:atdate	concept-date-n1944
concept-charactertrait-military-service	concept:atdate	concept-date-n1941
concept-charactertrait-return	concept:atdate	concept-year-n1919
concept-cheese-suffolk	concept:subpartof	concept-company-new-york
concept-chef-format	concept:agentinvolvedwithitem	concept-buildingfeature-window
concept-city-abidjan	concept:citycapitalofcountry	concept-country-ivory-coast
concept-city-abingdon	concept:atlocation	concept-stateorprovince-virginia
concept-city-abuja	concept:proxyfor	concept-country-nigeria
concept-city-akron	concept:citylocatedinstate	concept-stateorprovince-ohio
concept-city-alicante	concept:citylocatedingeopoliticallocation	concept-country-spain
concept-city-alliance	concept:atlocation	concept-stateorprovince-ohio
concept-city-anoka	concept:cityliesonriver	concept-attraction-mississippi
concept-city-army	concept:atdate	concept-date-n1941
concept-city-army	concept:atdate	concept-year-n1919
concept-city-ashland	concept:atlocation	concept-stateorprovince-virginia
concept-city-auckland	concept:citylocatedingeopoliticallocation	concept-country-papua-new-guinea
concept-city-avon-lake	concept:citylocatedinstate	concept-stateorprovince-ohio
concept-city-azerbaijan	concept:citycapitalofcountry	concept-country-azerbaijan
concept-city-beckley	concept:proxyfor	concept-stateorprovince-west-virginia
concept-city-bellingham	concept:citylocatedinstate	concept-visualizablescene-washington
concept-city-berea	concept:citylocatedinstate	concept-stateorprovince-ohio
concept-city-bermuda	concept:agentbelongstoorganization	concept-sportsleague-mls
concept-city-blue-springs	concept:proxyfor	concept-company-missouri
concept-city-bratislava	concept:proxyfor	concept-country-slovakia
concept-city-brazzaville	concept:citylocatedincountry	concept-country-democratic-republic-of-congo
concept-city-brooklyn	concept:subpartof	concept-county-york-city
concept-city-butler	concept:citylocatedinstate	concept-stateorprovince-ohio
concept-city-caledonia	concept:cityliesonriver	concept-attraction-grand
concept-city-cambridge	concept:proxyfor	concept-stateorprovince-ohio
concept-city-camdenton	concept:proxyfor	concept-company-missouri
concept-city-campbell	concept:citylocatedinstate	concept-stateorprovince-virginia
concept-city-canton	concept:locationlocatedwithinlocation	concept-stateorprovince-ohio
concept-city-capreol	concept:citylocatedinstate	concept-stateorprovince-ontario
concept-city-chantilly	concept:proxyfor	concept-stateorprovince-virginia
concept-city-chardon	concept:atlocation	concept-stateorprovince-ohio
concept-city-charleston	concept:cityliesonriver	concept-attraction-mississippi
concept-city-chatham-kent	concept:proxyfor	concept-stateorprovince-ontario
concept-city-chesapeake	concept:proxyfor	concept-stateorprovince-virginia
concept-city-chillicothe	concept:proxyfor	concept-company-missouri
concept-city-cleveland-heights	concept:citylocatedinstate	concept-stateorprovince-ohio
concept-city-cobourg	concept:citylocatedinstate	concept-stateorprovince-ontario
concept-city-columbia	concept:cityalsoknownas	concept-city-district
concept-city-columbia	concept:cityalsoknownas	concept-city-toronto
concept-city-columbia	concept:locationlocatedwithinlocation	concept-stateorprovince-virginia
concept-city-columbus-ohio	concept:citylocatedinstate	concept-stateorprovince-ohio
concept-city-commerce	concept:cityliesonriver	concept-attraction-mississippi
concept-city-communities	concept:subpartoforganization	concept-terroristorganization-state
concept-city-comstock-park	concept:cityliesonriver	concept-attraction-grand
concept-city-contents	concept:agentinvolvedwithitem	concept-buildingfeature-window
concept-city-costa-rica	concept:agentbelongstoorganization	concept-sportsleague-mls
concept-city-crookston	concept:cityliesonriver	concept-attraction-grand
concept-city-demonstration	concept:agentinvolvedwithitem	concept-buildingfeature-window
concept-city-dexter	concept:proxyfor	concept-company-missouri
concept-city-discussion	concept:agentinvolvedwithitem	concept-buildingfeature-window
concept-city-download	concept:agentinvolvedwithitem	concept-buildingfeature-window
concept-city-dublin-dublin	concept:citylocatedingeopoliticallocation	concept-country-republic
concept-city-duncan	concept:proxyfor	concept-stateorprovince-oklahoma
concept-city-edinburgh	concept:proxyfor	concept-country-scotland
concept-city-erie	concept:citylocatedinstate	concept-stateorprovince-ohio
concept-city-eskilstuna	concept:citylocatedincountry	concept-country-sweden
concept-city-fayette	concept:proxyfor	concept-company-missouri
concept-city-flagstaff	concept:cityliesonriver	concept-attraction-grand
concept-city-flint	concept:cityliesonriver	concept-attraction-grand
concept-city-fort-madison	concept:cityliesonriver	concept-attraction-mississippi
concept-city-fremont	concept:atlocation	concept-stateorprovince-ohio
concept-city-fremont	concept:locationlocatedwithinlocation	concept-city-vegas
concept-city-friedman	concept:agentcollaborateswithagent	concept-musicartist-times
concept-city-front-royal	concept:atlocation	concept-stateorprovince-virginia
concept-city-fukuoka	concept:cityliesonriver	concept-attraction-grand
concept-city-geneva	concept:cityliesonriver	concept-river-rhone
concept-city-grafton	concept:cityliesonriver	concept-attraction-mississippi
concept-city-grand-haven	concept:cityliesonriver	concept-attraction-grand
concept-city-greater-cleveland	concept:citylocatedinstate	concept-stateorprovince-ohio
concept-city-greenville	concept:cityliesonriver	concept-attraction-mississippi
concept-city-greenwood	concept:cityliesonriver	concept-attraction-mississippi
concept-city-grenada	concept:agentbelongstoorganization	concept-sportsleague-mls
concept-city-guatemala-city	concept:agentbelongstoorganization	concept-sportsleague-mls
concept-city-guyana	concept:agentbelongstoorganization	concept-sportsleague-mls
concept-city-hannibal	concept:proxyfor	concept-company-missouri
concept-city-hardy	concept:citylocatedinstate	concept-stateorprovince-west-virginia
concept-city-hastings	concept:cityliesonriver	concept-attraction-mississippi
concept-city-hong-kong-island	concept:cityliesonriver	concept-attraction-grand
concept-city-hornepayne	concept:citylocatedinstate	concept-stateorprovince-ontario
concept-city-hornepayne	concept:latitudelongitude	49.2035425000000,-84.7883400000000
concept-city-huntington	concept:atlocation	concept-stateorprovince-west-virginia
concept-city-hurricane	concept:proxyfor	concept-stateorprovince-west-virginia
concept-city-itasca	concept:cityliesonriver	concept-attraction-mississippi
concept-city-jackson	concept:cityliesonriver	concept-attraction-grand
concept-city-jamaica	concept:agentbelongstoorganization	concept-sportsleague-mls
concept-city-kano	concept:locationlocatedwithinlocation	concept-country-nigeria
concept-city-kiruna	concept:citylocatedincountry	concept-country-sweden
concept-city-lake-city	concept:citylocatedinstate	concept-stateorprovince-florida
concept-city-lancaster	concept:atlocation	concept-stateorprovince-ohio
concept-city-lees-summit	concept:proxyfor	concept-company-missouri
concept-city-lewisburg	concept:proxyfor	concept-stateorprovince-west-virginia
concept-city-lima	concept:atlocation	concept-stateorprovince-ohio
concept-city-lima	concept:citycapitalofcountry	concept-country-peru
concept-city-listings	concept:agentinvolvedwithitem	concept-buildingfeature-window
concept-city-lorain	concept:atlocation	concept-stateorprovince-ohio
concept-city-losuia	concept:citylocatedincountry	concept-country-papua-new-guinea
concept-city-lunenburg	concept:citylocatedinstate	concept-stateorprovince-virginia
concept-city-lyon	concept:cityliesonriver	concept-river-rh-ne
concept-city-lyon	concept:cityliesonriver	concept-river-rhone
concept-city-madrid	concept:citycapitalofcountry	concept-country-spain
concept-city-malaga	concept:citylocatedingeopoliticallocation	concept-country-spain
concept-city-manila	concept:proxyfor	concept-country-philippines
concept-city-marietta	concept:atlocation	concept-stateorprovince-ohio
concept-city-marion	concept:atlocation	concept-stateorprovince-ohio
concept-city-martinsburg	concept:atlocation	concept-stateorprovince-west-virginia
concept-city-martinsville	concept:subpartof	concept-stateorprovince-virginia
concept-city-marysville	concept:proxyfor	concept-stateorprovince-ohio
concept-city-maryville	concept:citylocatedinstate	concept-stateorprovince-northwest-missouri
concept-city-maryville	concept:proxyfor	concept-company-missouri
concept-city-mason	concept:atlocation	concept-stateorprovince-ohio
concept-city-melbourne	concept:citylocatedinstate	concept-stateorprovince-florida
concept-city-miamisburg	concept:atlocation	concept-stateorprovince-ohio
concept-city-middletown	concept:atlocation	concept-stateorprovince-ohio
concept-city-milford	concept:atlocation	concept-stateorprovince-ohio
concept-city-milford	concept:proxyfor	concept-stateorprovince-connecticut
concept-city-minneapolis	concept:proxyfor	concept-attraction-first-avenue
concept-city-mississauga	concept:proxyfor	concept-stateorprovince-ontario
concept-city-moundsville	concept:proxyfor	concept-stateorprovince-west-virginia
concept-city-muscatine	concept:cityliesonriver	concept-attraction-mississippi
concept-city-nassau	concept:citycapitalofcountry	concept-country-bahamas
concept-city-nassau	concept:proxyfor	concept-geopoliticalorganization-the-bahamas
concept-city-nauvoo	concept:cityliesonriver	concept-attraction-mississippi
concept-city-nebraska	concept:cityliesonriver	concept-attraction-grand
concept-city-newark	concept:atlocation	concept-stateorprovince-ohio
concept-city-nouakchott	concept:citylocatedincountry	concept-country-mauritania
concept-city-osage-beach	concept:proxyfor	concept-company-missouri
concept-city-outlook	concept:mutualproxyfor	concept-university-microsoft
concept-city-ozark	concept:atlocation	concept-stateorprovince-alabama
concept-city-painesville	concept:cityliesonriver	concept-attraction-grand
concept-city-parkersburg	concept:locationlocatedwithinlocation	concept-stateorprovince-west-virginia
concept-city-pendleton	concept:citylocatedinstate	concept-stateorprovince-west-virginia
concept-city-pictures	concept:agentinvolvedwithitem	concept-buildingfeature-window
concept-city-poplar-bluff	concept:proxyfor	concept-company-missouri
concept-city-port-hudson	concept:cityliesonriver	concept-attraction-mississippi
concept-city-port-moresby	concept:atdate	concept-date-n1942
concept-city-port-moresby	concept:citylocatedingeopoliticallocation	concept-country-papua-new-guinea
concept-city-portage	concept:citylocatedinstate	concept-stateorprovince-ohio
concept-city-portland	concept:cityliesonriver	concept-attraction-grand
concept-city-preston	concept:citylocatedinstate	concept-stateorprovince-west-virginia
concept-city-quito	concept:citylocatedingeopoliticallocation	concept-country-equador
concept-city-randolph	concept:citylocatedinstate	concept-stateorprovince-west-virginia
concept-city-red-wing	concept:cityliesonriver	concept-attraction-mississippi
concept-city-reston	concept:proxyfor	concept-stateorprovince-virginia
concept-city-reynoldsburg	concept:subpartof	concept-stateorprovince-ohio
concept-city-rock-island	concept:cityliesonriver	concept-attraction-mississippi
concept-city-ronneby	concept:citylocatedincountry	concept-country-sweden
concept-city-saint-joseph	concept:proxyfor	concept-company-missouri
concept-city-saint-louis	concept:cityliesonriver	concept-attraction-mississippi
concept-city-salem	concept:mutualproxyfor	concept-stateorprovince-virginia
concept-city-sandusky	concept:atlocation	concept-stateorprovince-ohio
concept-city-sao-paulo	concept:cityliesonriver	concept-attraction-grand
concept-city-seattle	concept:citylocatedinstate	concept-visualizablescene-washington
concept-city-sedona	concept:cityliesonriver	concept-attraction-grand
concept-city-seneca	concept:citylocatedinstate	concept-stateorprovince-ohio
concept-city-seoul	concept:cityliesonriver	concept-attraction-grand
concept-city-seoul	concept:citylocatedincountry	concept-country-republic
concept-city-sigtuna	concept:citylocatedincountry	concept-country-sweden
concept-city-sources	concept:agentinvolvedwithitem	concept-buildingfeature-window
concept-city-spring	concept:citylocatedinstate	concept-stateorprovince-virginia
concept-city-st---cloud	concept:cityliesonriver	concept-attraction-grand
concept-city-st-paul	concept:cityliesonriver	concept-attraction-mississippi
concept-city-steubenville	concept:proxyfor	concept-stateorprovince-ohio
concept-city-summit	concept:citylocatedinstate	concept-stateorprovince-ohio
concept-city-sveg	concept:citylocatedincountry	concept-country-sweden
concept-city-thief-river-falls	concept:cityliesonriver	concept-attraction-grand
concept-city-tokyo	concept:cityliesonriver	concept-attraction-grand
concept-city-toronto	concept:citylocatedinstate	concept-stateorprovince-ontario
concept-city-valencia	concept:citylocatedincountry	concept-country-spain
concept-city-videos	concept:agentinvolvedwithitem	concept-buildingfeature-window
concept-city-wapakoneta	concept:citylocatedingeopoliticallocation	concept-stateorprovince-ohio
concept-city-warren	concept:cityliesonriver	concept-attraction-grand
concept-city-warren	concept:proxyfor	concept-creditunion-michigan
concept-city-warrensburg	concept:proxyfor	concept-company-missouri
concept-city-warsaw	concept:proxyfor	concept-country-poland
concept-city-waterloo	concept:proxyfor	concept-stateorprovince-ontario
concept-city-wawa	concept:citylocatedinstate	concept-stateorprovince-ontario
concept-city-weirton	concept:proxyfor	concept-stateorprovince-west-virginia
concept-city-west-plains	concept:proxyfor	concept-company-missouri
concept-city-westlake	concept:atlocation	concept-stateorprovince-ohio
concept-city-wheeling	concept:proxyfor	concept-stateorprovince-west-virginia
concept-city-winfield	concept:cityliesonriver	concept-attraction-mississippi
concept-city-winnipeg	concept:cityliesonriver	concept-attraction-grand
concept-city-woodbridge	concept:proxyfor	concept-stateorprovince-virginia
concept-city-zouerate	concept:citylocatedincountry	concept-country-mauritania
concept-clothing-belt	concept:clothingtogowithclothing	concept-clothing-jacket
concept-clothing-belt	concept:clothingtogowithclothing	concept-visualizableobject-shirt
concept-clothing-belt	concept:objectfoundinscene	concept-landscapefeatures-valley
concept-clothing-black-tie	concept:clothingtogowithclothing	concept-visualizableobject-shirt
concept-clothing-blue-jeans	concept:clothingtogowithclothing	concept-clothing-jacket
concept-clothing-blue-suit	concept:clothingtogowithclothing	concept-visualizableobject-shirt
concept-clothing-cloak	concept:clothingtogowithclothing	concept-clothing-hat
concept-clothing-clothes	concept:clothingtogowithclothing	concept-clothing-shirts
concept-clothing-dress	concept:clothingtogowithclothing	concept-visualizableobject-shirt
concept-clothing-dress-shoes	concept:clothingtogowithclothing	concept-visualizableobject-shirt
concept-clothing-gloves	concept:clothingtogowithclothing	concept-visualizableobject-shirt
concept-clothing-gym-pants	concept:clothingtogowithclothing	concept-visualizableobject-shirt
concept-clothing-hat	concept:clothingtogowithclothing	concept-clothing-brown-suit
concept-clothing-hat	concept:clothingtogowithclothing	concept-clothing-leather-coat
concept-clothing-hat	concept:clothingtogowithclothing	concept-clothing-pinstripe-suit
concept-clothing-hat	concept:clothingtogowithclothing	concept-clothing-sun-glasses
concept-clothing-hat	concept:clothingtogowithclothing	concept-clothing-trenchcoat
concept-clothing-hat	concept:clothingtogowithclothing	concept-visualizableobject-shirt
concept-clothing-heels	concept:clothingtogowithclothing	concept-visualizableobject-shirt
concept-clothing-jacket	concept:clothingtogowithclothing	concept-clothing-blouse
concept-clothing-jacket	concept:clothingtogowithclothing	concept-clothing-sweat-pants
concept-clothing-jacket	concept:clothingtogowithclothing	concept-clothing-sweatshirt
concept-clothing-jacket	concept:clothingtogowithclothing	concept-clothing-tee
concept-clothing-jacket	concept:clothingtogowithclothing	concept-clothing-tie
concept-clothing-jacket	concept:clothingtogowithclothing	concept-clothing-vest
concept-clothing-jogging-pants	concept:clothingtogowithclothing	concept-visualizableobject-shirt
concept-clothing-long-black-coat	concept:clothingtogowithclothing	concept-clothing-hat
concept-clothing-long-coat	concept:clothingtogowithclothing	concept-clothing-hat
concept-clothing-long-pants	concept:clothingtogowithclothing	concept-clothing-jacket
concept-clothing-navy-shorts	concept:clothingtogowithclothing	concept-visualizableobject-shirt
concept-clothing-overcoat	concept:clothingtogowithclothing	concept-clothing-hat
concept-clothing-protective-clothing	concept:clothingtogowithclothing	concept-clothing-hat
concept-clothing-raincoat	concept:clothingtogowithclothing	concept-visualizableobject-shirt
concept-clothing-robes	concept:clothingmadefromplant	concept-plant-bamboo
concept-clothing-robes	concept:itemfoundinroom	concept-visualizablething-bedrooms
concept-clothing-shirts	concept:clothingtogowithclothing	concept-clothing-jacket
concept-clothing-shirts	concept:clothingtogowithclothing	concept-clothing-long-sleeves
concept-clothing-shirts	concept:clothingtogowithclothing	concept-clothing-socks
concept-clothing-shirts	concept:clothingtogowithclothing	concept-clothing-underwear
concept-clothing-skirt	concept:clothingtogowithclothing	concept-clothing-jacket
concept-clothing-stockings	concept:clothingtogowithclothing	concept-clothing-hat
concept-clothing-tie	concept:clothingtogowithclothing	concept-clothing-white-suit
concept-clothing-trousers	concept:clothingtogowithclothing	concept-clothing-jacket
concept-clothing-tshirt	concept:clothingtogowithclothing	concept-visualizableobject-shirt
concept-clothing-white-shirt	concept:clothingtogowithclothing	concept-clothing-jacket
concept-clothing-white-shorts	concept:clothingtogowithclothing	concept-visualizableobject-shirt
concept-clothing-white-socks	concept:clothingtogowithclothing	concept-visualizableobject-shirt
concept-clothing-wig	concept:clothingtogowithclothing	concept-clothing-hat
concept-coach-brandon-dubinsky	concept:athletehomestadium	concept-stadiumoreventvenue-giants-stadium
concept-coach-daunte-culpepper	concept:athleteplayssportsteamposition	concept-sportsteamposition-player
concept-coach-fredrik-sjostrom	concept:athletehomestadium	concept-stadiumoreventvenue-giants-stadium
concept-coach-jay-feely	concept:athletehomestadium	concept-stadiumoreventvenue-giants-stadium
concept-coach-key	concept:agentinvolvedwithitem	concept-buildingfeature-window
concept-coach-ladainian-tomlinson	concept:athleteplayssportsteamposition	concept-sportsteamposition-running-back
concept-coach-lebron-james	concept:athleteplayssportsteamposition	concept-sportsteamposition-player
concept-coach-lenny-moore	concept:athleteplayssportsteamposition	concept-sportsteamposition-running-back
concept-coach-marshall-faulk	concept:athleteplayssportsteamposition	concept-sportsteamposition-running-back
concept-coach-new-york-red-bulls	concept:agentbelongstoorganization	concept-sportsleague-mls
concept-coach-nikolai-zherdev	concept:athletehomestadium	concept-stadiumoreventvenue-giants-stadium
concept-coach-occupation	concept:atdate	concept-date-n1941
concept-coach-peter-moylan	concept:athleteplayssportsteamposition	concept-sportsteamposition-player
concept-coach-zidane	concept:athleteplayssportsteamposition	concept-sportsteamposition-player
concept-comedian-john-chancellor	concept:subpartof	concept-retailstore-nbc
concept-comedian-richard	concept:persondiedatage	2
concept-company-access	concept:subpartoforganization	concept-company-adobe
concept-company-adobe	concept:agentcreated	concept-mlalgorithm-microsoft-word
concept-company-adobe	concept:agentcreated	concept-product-word-documents
concept-company-adobe	concept:agentcreated	concept-website-download
concept-company-adobe	concept:agentinvolvedwithitem	concept-buildingfeature-window
concept-company-adobe	concept:agentinvolvedwithitem	concept-consumerelectronicitem-ms-word
concept-company-adobe	concept:agentinvolvedwithitem	concept-product-powerpoint
concept-company-air-niugini	concept:organizationheadquarteredincity	concept-city-port-moresby
concept-company-arizona	concept:companyeconomicsector	concept-economicsector-insurance-coverage
concept-company-at-t	concept:acquired	concept-company-bellsouth
concept-company-at-t	concept:companyeconomicsector	concept-economicsector-telecoms
concept-company-at-t	concept:hasofficeincity	concept-city-middletown
concept-company-at-t	concept:organizationterminatedperson	concept-ceo-c--michael-armstrong
concept-company-at-t	concept:organizationterminatedperson	concept-ceo-randall-l--stephenson
concept-company-at-t	concept:organizationterminatedperson	concept-person-ed-whitacre
concept-company-at-t	concept:subpartoforganization	concept-company-sprint-nextel
concept-company-bahamas-air	concept:headquarteredin	concept-city-nassau
concept-company-bahamasair	concept:hasofficeincity	concept-city-nassau
concept-company-canada	concept:companyeconomicsector	concept-economicsector-insurance
concept-company-canada	concept:hasofficeincountry	concept-country---america
concept-company-companies	concept:companyeconomicsector	concept-economicsector-insurance
concept-company-delta	concept:acquired	concept-company-northwest-airlines
concept-company-delta	concept:hasofficeincity	concept-city-las-vegas
concept-company-dialog	concept:agentinvolvedwithitem	concept-buildingfeature-window
concept-company-easyjet	concept:hasofficeincity	concept-city-belfast
concept-company-easyjet	concept:hasofficeincity	concept-city-edinburgh
concept-company-easyjet	concept:hasofficeincity	concept-city-geneva
concept-company-firefly	concept:subpartoforganization	concept-university-microsoft
concept-company-flybe	concept:acquired	concept-company-ba-connect
concept-company-flybe	concept:hasofficeincity	concept-city-bergerac
concept-company-flybe	concept:hasofficeincity	concept-city-brest
concept-company-general	concept:hasofficeincountry	concept-country-scotland
concept-company-general-mills	concept:organizationheadquarteredincity	concept-city-minneapolis
concept-company-general-mills001	concept:agentcollaborateswithagent	concept-magazine-pillsbury
concept-company-general-mills001	concept:headquarteredin	concept-city-minneapolis
concept-company-general-motors	concept:companyeconomicsector	concept-economicsector-auto
concept-company-general-motors	concept:competeswith	concept-company-chrysler
concept-company-iran	concept:hasofficeincountry	concept-country---america
concept-company-japan	concept:atdate	concept-date-n1941
concept-company-missouri	concept:atdate	concept-date-n1864
concept-company-missouri	concept:mutualproxyfor	concept-city-rolla
concept-company-missouri	concept:mutualproxyfor	concept-room-saint-charles
concept-company-missouri	concept:mutualproxyfor	concept-sociopolitical-independence
concept-company-missouri	concept:mutualproxyfor	concept-televisionstation-saint-louis
concept-company-missouri	concept:mutualproxyfor	concept-visualizablescene-joplin
concept-company-missouri	concept:organizationterminatedperson	concept-personaustralia-gary-pinkel
concept-company-missouri	concept:organizationterminatedperson	concept-personmexico-mike-anderson
concept-company-missouri	concept:organizationterminatedperson	concept-personus-norm-stewart
concept-company-msn-search	concept:agentcompeteswithagent	concept-university-search
concept-company-netherlands	concept:hasofficeincountry	concept-country---america
concept-company-new-york	concept:agentcompeteswithagent	concept-musicartist-times
concept-company-new-york	concept:companyeconomicsector	concept-economicsector-insurance-coverage
concept-company-new-york	concept:competeswith	concept-company-yahoo001
concept-company-new-york	concept:competeswith	concept-politicsblog-tribune
concept-company-new-york	concept:competeswith	concept-politicsblog-village-voice
concept-company-new-york	concept:competeswith	concept-televisionstation-los-angeles-times
concept-company-northwest-airlines	concept:hasofficeincity	concept-city-amsterdam
concept-company-northwest-airlines	concept:hasofficeincity	concept-city-manila
concept-company-pbs	concept:acquired	concept-company-kues
concept-company-pbs	concept:agentcontrols	concept-televisionstation-kaet
concept-company-pbs	concept:agentcontrols	concept-televisionstation-kaft
concept-company-pbs	concept:agentcontrols	concept-televisionstation-kawe
concept-company-pbs	concept:agentcontrols	concept-televisionstation-kbhe-tv
concept-company-pbs	concept:agentcontrols	concept-televisionstation-kbme-tv
concept-company-pbs	concept:agentcontrols	concept-televisionstation-kbtc-tv
concept-company-pbs	concept:agentcontrols	concept-televisionstation-kcge-dt
concept-company-pbs	concept:agentcontrols	concept-televisionstation-kcos-tv
concept-company-pbs	concept:agentcontrols	concept-televisionstation-kdck
concept-company-pbs	concept:agentcontrols	concept-televisionstation-kesd-tv
concept-company-pbs	concept:agentcontrols	concept-televisionstation-kisu-tv
concept-company-pbs	concept:agentcontrols	concept-televisionstation-klpb-tv
concept-company-pbs	concept:agentcontrols	concept-televisionstation-klru
concept-company-pbs	concept:agentcontrols	concept-televisionstation-kmbh-tv
concept-company-pbs	concept:agentcontrols	concept-televisionstation-kmos-tv
concept-company-pbs	concept:agentcontrols	concept-televisionstation-kocv-tv
concept-company-pbs	concept:agentcontrols	concept-televisionstation-kood
concept-company-pbs	concept:agentcontrols	concept-televisionstation-kozk
concept-company-pbs	concept:agentcontrols	concept-televisionstation-kpsd-tv
concept-company-pbs	concept:agentcontrols	concept-televisionstation-kpts
concept-company-pbs	concept:agentcontrols	concept-televisionstation-krcb
concept-company-pbs	concept:agentcontrols	concept-televisionstation-krne-tv
concept-company-pbs	concept:agentcontrols	concept-televisionstation-krsc-tv
concept-company-pbs	concept:agentcontrols	concept-televisionstation-krwg-tv
concept-company-pbs	concept:agentcontrols	concept-televisionstation-kswk
concept-company-pbs	concept:agentcontrols	concept-televisionstation-ktci-tv
concept-company-pbs	concept:agentcontrols	concept-televisionstation-ktnw
concept-company-pbs	concept:agentcontrols	concept-televisionstation-ktsc-tv
concept-company-pbs	concept:agentcontrols	concept-televisionstation-kuas-tv
concept-company-pbs	concept:agentcontrols	concept-televisionstation-kuat-tv
concept-company-pbs	concept:agentcontrols	concept-televisionstation-kued
concept-company-pbs	concept:agentcontrols	concept-televisionstation-kufm-tv
concept-company-pbs	concept:agentcontrols	concept-televisionstation-kuon-tv
concept-company-pbs	concept:agentcontrols	concept-televisionstation-kusm
concept-company-pbs	concept:agentcontrols	concept-televisionstation-kxne-tv
concept-company-pbs	concept:agentcontrols	concept-televisionstation-kyne-tv
concept-company-pbs	concept:agentcontrols	concept-televisionstation-wbcc-tv
concept-company-pbs	concept:agentcontrols	concept-televisionstation-wbiq-tv
concept-company-pbs	concept:agentcontrols	concept-televisionstation-wcfe-tv
concept-company-pbs	concept:agentcontrols	concept-televisionstation-wetp-tv
concept-company-pbs	concept:agentcontrols	concept-televisionstation-wfpt
concept-company-pbs	concept:agentcontrols	concept-televisionstation-wfsu-tv
concept-company-pbs	concept:agentcontrols	concept-televisionstation-wgbx-tv
concept-company-pbs	concept:agentcontrols	concept-televisionstation-wgby-tv
concept-company-pbs	concept:agentcontrols	concept-televisionstation-wgcu-tv
concept-company-pbs	concept:agentcontrols	concept-televisionstation-wgpt
concept-company-pbs	concept:agentcontrols	concept-televisionstation-wgte-tv
concept-company-pbs	concept:agentcontrols	concept-televisionstation-wha--tv
concept-company-pbs	concept:agentcontrols	concept-televisionstation-whla-tv
concept-company-pbs	concept:agentcontrols	concept-televisionstation-whro-tv
concept-company-pbs	concept:agentcontrols	concept-televisionstation-wiiq
concept-company-pbs	concept:agentcontrols	concept-televisionstation-wkha
concept-company-pbs	concept:agentcontrols	concept-televisionstation-wkle
concept-company-pbs	concept:agentcontrols	concept-televisionstation-wkma
concept-company-pbs	concept:agentcontrols	concept-televisionstation-wkmu
concept-company-pbs	concept:agentcontrols	concept-televisionstation-wkno-tv
concept-company-pbs	concept:agentcontrols	concept-televisionstation-wkop-tv
concept-company-pbs	concept:agentcontrols	concept-televisionstation-wkpi
concept-company-pbs	concept:agentcontrols	concept-televisionstation-wkso-tv
concept-company-pbs	concept:agentcontrols	concept-televisionstation-wkyu-tv
concept-company-pbs	concept:agentcontrols	concept-televisionstation-wkzt-tv
concept-company-pbs	concept:agentcontrols	concept-televisionstation-wlef-tv
concept-company-pbs	concept:agentcontrols	concept-televisionstation-wlpb-tv
concept-company-pbs	concept:agentcontrols	concept-televisionstation-wlvt-tv
concept-company-pbs	concept:agentcontrols	concept-televisionstation-wmed-tv
concept-company-pbs	concept:agentcontrols	concept-televisionstation-wmfe-tv
concept-company-pbs	concept:agentcontrols	concept-televisionstation-wmpn-tv
concept-company-pbs	concept:agentcontrols	concept-televisionstation-wmpt
concept-company-pbs	concept:agentcontrols	concept-televisionstation-wmvs-tv
concept-company-pbs	concept:agentcontrols	concept-televisionstation-wneo
concept-company-pbs	concept:agentcontrols	concept-televisionstation-wnin-tv
concept-company-pbs	concept:agentcontrols	concept-televisionstation-wnit-tv
concept-company-pbs	concept:agentcontrols	concept-televisionstation-wnjn
concept-company-pbs	concept:agentcontrols	concept-televisionstation-wnsc-tv
concept-company-pbs	concept:agentcontrols	concept-televisionstation-wosu-tv
concept-company-pbs	concept:agentcontrols	concept-televisionstation-wpba
concept-company-pbs	concept:agentcontrols	concept-televisionstation-wpbo-tv
concept-company-pbs	concept:agentcontrols	concept-televisionstation-wpby-tv
concept-company-pbs	concept:agentcontrols	concept-televisionstation-wpto
concept-company-pbs	concept:agentcontrols	concept-televisionstation-wqec
concept-company-pbs	concept:agentcontrols	concept-televisionstation-wqpt-tv
concept-company-pbs	concept:agentcontrols	concept-televisionstation-wsbn-tv
concept-company-pbs	concept:agentcontrols	concept-televisionstation-wsre
concept-company-pbs	concept:agentcontrols	concept-televisionstation-wtiu-tv
concept-company-pbs	concept:agentcontrols	concept-televisionstation-wunc-tv
concept-company-pbs	concept:agentcontrols	concept-televisionstation-wund-tv
concept-company-pbs	concept:agentcontrols	concept-televisionstation-wunm-tv
concept-company-pbs	concept:agentcontrols	concept-televisionstation-wunp-tv
concept-company-pbs	concept:agentcontrols	concept-televisionstation-wvta
concept-company-pbs	concept:agentcontrols	concept-televisionstation-wxxi-tv
concept-company-ryanair	concept:hasofficeincity	concept-city-aberdeen
concept-company-ryanair	concept:hasofficeincity	concept-city-ancona
concept-company-ryanair	concept:hasofficeincity	concept-city-billund
concept-company-ryanair	concept:hasofficeincity	concept-city-bologna
concept-company-ryanair	concept:hasofficeincity	concept-city-bremen
concept-company-ryanair	concept:hasofficeincity	concept-city-brest
concept-company-ryanair	concept:hasofficeincity	concept-city-brindisi
concept-company-ryanair	concept:hasofficeincity	concept-city-edinburgh
concept-company-ryanair	concept:hasofficeincity	concept-city-frankfurt
concept-company-ryanair	concept:hasofficeincity	concept-city-friedrichshafen
concept-company-ryanair	concept:hasofficeincity	concept-city-gothenburg
concept-company-ryanair	concept:hasofficeincity	concept-city-granada
concept-company-ryanair	concept:hasofficeincity	concept-city-graz
concept-company-ryanair	concept:hasofficeincity	concept-city-hamburg
concept-company-ryanair	concept:hasofficeincity	concept-city-milan
concept-company-ryanair	concept:hasofficeincity	concept-city-montpellier
concept-company-ryanair	concept:hasofficeincity	concept-city-pisa
concept-company-ryanair	concept:hasofficeincity	concept-city-seville
concept-company-ryanair	concept:hasofficeincity	concept-city-tampere
concept-company-ryanair	concept:hasofficeincity	concept-geopoliticallocation-santander
concept-company-ryanair	concept:hasofficeincity	concept-geopoliticallocation-zadar
concept-company-ryanair	concept:hasofficeincity	concept-visualizablething-biarritz
concept-company-ryanair	concept:headquarteredin	concept-city-glasgow
concept-company-sbc-communications-inc-	concept:acquired	concept-company-at-t
concept-company-services	concept:agentinvolvedwithitem	concept-buildingfeature-windows
concept-company-services	concept:organizationalsoknownas	concept-sportsleague-field
concept-company-stories	concept:agentinvolvedwithitem	concept-buildingfeature-window
concept-company-subaru-of-america	concept:organizationacronymhasname	concept-automobilemaker-subaru
concept-company-target	concept:hasofficeincity	concept-city-minneapolis
concept-company-user	concept:agentinvolvedwithitem	concept-buildingfeature-window
concept-company-village-voice-media	concept:agentcontrols	concept-journalist-james-ridgeway
concept-company-village-voice-media	concept:agentcontrols	concept-musician-nat-hentoff
concept-company-wikipedia	concept:competeswith	concept-company-yahoo001
concept-company-wipo	concept:headquarteredin	concept-city-geneva
concept-company-world-meteorological-organization	concept:headquarteredin	concept-city-geneva
concept-company-wto001	concept:headquarteredin	concept-city-geneva
concept-company-yahoo001	concept:acquired	concept-website-inktomi
concept-country---america	concept:countryalsoknownas	concept-country-australasia
concept-country---america	concept:organizationhiredperson	concept-personnorthamerica-kenneth-d--lewis
concept-country-african-republic	concept:countryalsoknownas	concept-country-democratic-republic-of-congo
concept-country-arabia-saudita	concept:countrylocatedingeopoliticallocation	concept-geopoliticallocation-middle-east
concept-country-bric	concept:countrylocatedingeopoliticallocation	concept-country-countries
concept-country-brunei	concept:countrylocatedingeopoliticallocation	concept-continent-asia
concept-country-burma	concept:countrylocatedingeopoliticallocation	concept-country-countries
concept-country-cayman-islands	concept:countrylocatedingeopoliticallocation	concept-country-countries
concept-country-democratic-republic-of-congo	concept:countryalsoknownas	concept-country-republic-of-benin
concept-country-democratic-republic-of-congo	concept:countryalsoknownas	concept-country-south-sudan
concept-country-djibouti	concept:countrylocatedingeopoliticallocation	concept-continent-africa
concept-country-equador	concept:countrylocatedingeopoliticallocation	concept-country-countries
concept-country-eu-member-states	concept:countrylocatedingeopoliticallocation	concept-country-countries
concept-country-gambia	concept:agentbelongstoorganization	concept-sportsleague-mls
concept-country-hungary	concept:countrylocatedingeopoliticallocation	concept-country-eastern-european-countries
concept-country-israel	concept:atdate	concept-month-september
concept-country-kuwait	concept:countrylocatedingeopoliticallocation	concept-country-countries
concept-country-laos	concept:countrylocatedingeopoliticallocation	concept-continent-asia
concept-country-luxemburg	concept:countrylocatedingeopoliticallocation	concept-country-countries
concept-country-malaya	concept:countrylocatedingeopoliticallocation	concept-country-countries
concept-country-maldives	concept:countrylocatedingeopoliticallocation	concept-country-countries
concept-country-peru	concept:countryalsoknownas	concept-country-republic
concept-country-peru	concept:countrylocatedingeopoliticallocation	concept-geopoliticallocation-destinations
concept-country-philippines	concept:countrylocatedingeopoliticallocation	concept-continent-asia
concept-country-poland	concept:atdate	concept-date-n1941
concept-country-republic	concept:countryalsoknownas	concept-country---america
concept-country-republic	concept:countryalsoknownas	concept-country-albania
concept-country-republic	concept:countryalsoknownas	concept-country-algeria
concept-country-republic	concept:countryalsoknownas	concept-country-arabia-saudita
concept-country-republic	concept:countryalsoknownas	concept-country-armenia
concept-country-republic	concept:countryalsoknownas	concept-country-aruba
concept-country-republic	concept:countryalsoknownas	concept-country-azerbaijan
concept-country-republic	concept:countryalsoknownas	concept-country-bahamas
concept-country-republic	concept:countryalsoknownas	concept-country-barbados
concept-country-republic	concept:countryalsoknownas	concept-country-bulgaria
concept-country-republic	concept:countryalsoknownas	concept-country-burkina
concept-country-republic	concept:countryalsoknownas	concept-country-burundi
concept-country-republic	concept:countryalsoknownas	concept-country-cameroon
concept-country-republic	concept:countryalsoknownas	concept-country-central-african-republic
concept-country-republic	concept:countryalsoknownas	concept-country-comoros
concept-country-republic	concept:countryalsoknownas	concept-country-costa-rica
concept-country-republic	concept:countryalsoknownas	concept-country-cuba
concept-country-republic	concept:countryalsoknownas	concept-country-cyprus
concept-country-republic	concept:countryalsoknownas	concept-country-darfur
concept-country-republic	concept:countryalsoknownas	concept-country-darfur-region
concept-country-republic	concept:countryalsoknownas	concept-country-democratic-republic-of-congo
concept-country-republic	concept:countryalsoknownas	concept-country-djibouti
concept-country-republic	concept:countryalsoknownas	concept-country-drc
concept-country-republic	concept:countryalsoknownas	concept-country-el-salvador
concept-country-republic	concept:countryalsoknownas	concept-country-equator--guinea
concept-country-republic	concept:countryalsoknownas	concept-country-ethiopia
concept-country-republic	concept:countryalsoknownas	concept-country-former-soviet-union
concept-country-republic	concept:countryalsoknownas	concept-country-gabon
concept-country-republic	concept:countryalsoknownas	concept-country-gambia
concept-country-republic	concept:countryalsoknownas	concept-country-ghana
concept-country-republic	concept:countryalsoknownas	concept-country-guyana
concept-country-republic	concept:countryalsoknownas	concept-country-hungary
concept-country-republic	concept:countryalsoknownas	concept-country-iran
concept-country-republic	concept:countryalsoknownas	concept-country-ireland
concept-country-republic	concept:countryalsoknownas	concept-country-israel
concept-country-republic	concept:countryalsoknownas	concept-country-ivory-coast
concept-country-republic	concept:countryalsoknownas	concept-country-jordan
concept-country-republic	concept:countryalsoknownas	concept-country-kazakhstan
concept-country-republic	concept:countryalsoknownas	concept-country-lesotho
concept-country-republic	concept:countryalsoknownas	concept-country-liberia
concept-country-republic	concept:countryalsoknownas	concept-country-libya
concept-country-republic	concept:countryalsoknownas	concept-country-luxembourg
concept-country-republic	concept:countryalsoknownas	concept-country-macedonia
concept-country-republic	concept:countryalsoknownas	concept-country-madagascar
concept-country-republic	concept:countryalsoknownas	concept-country-malawi
concept-country-republic	concept:countryalsoknownas	concept-country-malaysia
concept-country-republic	concept:countryalsoknownas	concept-country-mali
concept-country-republic	concept:countryalsoknownas	concept-country-malta
concept-country-republic	concept:countryalsoknownas	concept-country-mauritania
concept-country-republic	concept:countryalsoknownas	concept-country-moldova
concept-country-republic	concept:countryalsoknownas	concept-country-mongolia
concept-country-republic	concept:countryalsoknownas	concept-country-montenegro
concept-country-republic	concept:countryalsoknownas	concept-country-morocco
concept-country-republic	concept:countryalsoknownas	concept-country-mozambique
concept-country-republic	concept:countryalsoknownas	concept-country-myanmar-burma
concept-country-republic	concept:countryalsoknownas	concept-country-nepal
concept-country-republic	concept:countryalsoknownas	concept-country-niger
concept-country-republic	concept:countryalsoknownas	concept-country-nigeria
concept-country-republic	concept:countryalsoknownas	concept-country-oman
concept-country-republic	concept:countryalsoknownas	concept-country-palestine
concept-country-republic	concept:countryalsoknownas	concept-country-panama
concept-country-republic	concept:countryalsoknownas	concept-country-papua-new-guinea
concept-country-republic	concept:countryalsoknownas	concept-country-philippines
concept-country-republic	concept:countryalsoknownas	concept-country-poland
concept-country-republic	concept:countryalsoknownas	concept-country-puerto-rico
concept-country-republic	concept:countryalsoknownas	concept-country-republic-of-angola
concept-country-republic	concept:countryalsoknownas	concept-country-republic-of-chad
concept-country-republic	concept:countryalsoknownas	concept-country-republic-of-lithuania
concept-country-republic	concept:countryalsoknownas	concept-country-republic-of-seychelles
concept-country-republic	concept:countryalsoknownas	concept-country-romania
concept-country-republic	concept:countryalsoknownas	concept-country-rwanda
concept-country-republic	concept:countryalsoknownas	concept-country-scandinavian-countries
concept-country-republic	concept:countryalsoknownas	concept-country-scotland
concept-country-republic	concept:countryalsoknownas	concept-country-sierra-leone
concept-country-republic	concept:countryalsoknownas	concept-country-slovak-republic
concept-country-republic	concept:countryalsoknownas	concept-country-slovakia
concept-country-republic	concept:countryalsoknownas	concept-country-slovenia
concept-country-republic	concept:countryalsoknownas	concept-country-somalia
concept-country-republic	concept:countryalsoknownas	concept-country-sudan
concept-country-republic	concept:countryalsoknownas	concept-country-sweden
concept-country-republic	concept:countryalsoknownas	concept-country-tanzania
concept-country-republic	concept:countryalsoknownas	concept-country-the-united-kingdom
concept-country-republic	concept:countryalsoknownas	concept-country-togo
concept-country-republic	concept:countryalsoknownas	concept-country-uk
concept-country-republic	concept:countryalsoknownas	concept-country-ukraine
concept-country-republic	concept:countryalsoknownas	concept-country-uruguay
concept-country-republic	concept:countryalsoknownas	concept-country-venezuela
concept-country-republic	concept:countryalsoknownas	concept-country-wales
concept-country-republic	concept:countryalsoknownas	concept-country-zimbabwe
concept-country-republic	concept:countrylocatedingeopoliticallocation	concept-country-countries
concept-country-republic	concept:countrylocatedingeopoliticallocation	concept-geopoliticallocation-european-nations
concept-country-saint-kitts-and-nevis	concept:agentbelongstoorganization	concept-sportsleague-mls
concept-country-scandinavia	concept:countrylocatedingeopoliticallocation	concept-geopoliticallocation-destinations
concept-country-scotland	concept:countrycurrency	concept-currency-pounds
concept-country-spain	concept:countrylocatedingeopoliticallocation	concept-geopoliticallocation-european-nations
concept-country-sweden	concept:countrycurrency	concept-currency-krona
concept-country-syria	concept:countrylocatedingeopoliticallocation	concept-country-countries
concept-country-the-philippines	concept:countryalsoknownas	concept-country-republic
concept-country-trinidad-and-tobago	concept:agentbelongstoorganization	concept-sportsleague-mls
concept-country-uk--canada	concept:countryalsoknownas	concept-country-republic
concept-country-ussr-	concept:countrylocatedingeopoliticallocation	concept-country-countries
concept-country-venezuela	concept:countrylocatedingeopoliticallocation	concept-geopoliticallocation-producers
concept-county-brooklyn	concept:mutualproxyfor	concept-company-new-york
concept-county-elkins	concept:locationlocatedwithinlocation	concept-stateorprovince-west-virginia
concept-county-paris	concept:atdate	concept-date-n1941
concept-county-radford	concept:proxyfor	concept-stateorprovince-virginia
concept-county-salem	concept:atlocation	concept-stateorprovince-ohio
concept-creditunion-michigan	concept:subpartoforganization	concept-sportsteam-ncaa-mens-midwest-regionals
concept-criminal-email	concept:agentinvolvedwithitem	concept-buildingfeature-window
concept-criminal-john	concept:persondiedatage	2
concept-criminal-thursday	concept:atdate	concept-date-community
concept-criminal-web-pages	concept:agentinvolvedwithitem	concept-buildingfeature-window
concept-date-bill	concept:subpartof	concept-university-microsoft
concept-date-dec-	concept:atdate	concept-date-community
concept-date-fall	concept:proxyfor	concept-stateorprovince-virginia
concept-date-feb-	concept:atdate	concept-date-community
concept-date-frontpage	concept:mutualproxyfor	concept-university-microsoft
concept-date-nov-	concept:atdate	concept-date-community
concept-date-sept-	concept:atdate	concept-date-community
concept-emotion-northeastern	concept:mutualproxyfor	concept-company-missouri
concept-emotion-word	concept:mutualproxyfor	concept-university-microsoft
concept-ethnicgroup-union-forces	concept:atdate	concept-year-n1865
concept-eventoutcome-battle	concept:atdate	concept-date-n1944
concept-female-daw-aung-san-suu-kyi	concept:personhasjobposition	concept-jobposition-leader
concept-female-sarah	concept:persondiedatage	2
concept-fish-anchovies	concept:agriculturalproductcutintogeometricshape	concept-geometricshape-bits
concept-fish-barracuda	concept:animalistypeofanimal	concept-fish-pelagics
concept-fish-billfish	concept:animalsuchasfish	concept-fish-blue-marlin
concept-fish-cod	concept:agriculturalproductcutintogeometricshape	concept-geometricshape-cubes
concept-fish-game-fish	concept:animalsuchasfish	concept-fish-marlin
concept-fish-gamefish	concept:animalsuchasfish	concept-fish-tuna
concept-fish-large-fish	concept:animalsuchasfish	concept-fish-marlin
concept-fish-large-fish	concept:animalsuchasfish	concept-fish-tuna
concept-fish-larger-fish	concept:animalsuchasfish	concept-fish-swordfish
concept-fish-manta-rays	concept:animalistypeofanimal	concept-fish-pelagics
concept-fish-mantas	concept:animalistypeofanimal	concept-fish-pelagics
concept-fish-oily-fish	concept:animalsuchasfish	concept-fish-tuna
concept-fish-pelagics	concept:animalsuchasfish	concept-fish-marlin
concept-fish-pelagics	concept:animalsuchasfish	concept-fish-sharks
concept-fish-pelagics	concept:animalsuchasfish	concept-fish-sunfish
concept-fish-predatory-fish	concept:animalsuchasfish	concept-fish-tuna
concept-fish-sailfish	concept:animalistypeofanimal	concept-fish-billfish
concept-fish-sharks	concept:animalistypeofanimal	concept-fish-fishes
concept-fish-sharks	concept:animalpreyson	concept-fish-sharks
concept-fish-swordfish	concept:animalistypeofanimal	concept-fish-billfish
concept-fish-swordfish	concept:animalistypeofanimal	concept-fish-tunas
concept-fish-swordfish	concept:fishservedwithfood	concept-bakedgood-butter
concept-fish-tours	concept:agentinvolvedwithitem	concept-buildingfeature-window
concept-fish-tuna	concept:agriculturalproductcutintogeometricshape	concept-geometricshape-cubes
concept-fish-tuna	concept:animaleatvegetable	concept-vegetable-lettuce
concept-fish-tuna	concept:fishservedwithfood	concept-agriculturalproduct-asparagus
concept-fish-tuna	concept:fishservedwithfood	concept-automobileengine-production
concept-fish-tuna	concept:fishservedwithfood	concept-bakedgood-appetizer
concept-fish-tuna	concept:fishservedwithfood	concept-bakedgood-pasta
concept-fish-tuna	concept:fishservedwithfood	concept-bakedgood-salad-sandwich
concept-fish-tuna	concept:fishservedwithfood	concept-bakedgood-sauce
concept-fish-tuna	concept:fishservedwithfood	concept-bakedgood-starter
concept-fish-tuna	concept:fishservedwithfood	concept-beverage--
concept-fish-tuna	concept:fishservedwithfood	concept-beverage-breakfast
concept-fish-tuna	concept:fishservedwithfood	concept-beverage-imports
concept-fish-tuna	concept:fishservedwithfood	concept-beverage-slice
concept-fish-tuna	concept:fishservedwithfood	concept-condiment-avocado
concept-fish-tuna	concept:fishservedwithfood	concept-condiment-crust
concept-fish-tuna	concept:fishservedwithfood	concept-condiment-ginger
concept-fish-tuna	concept:fishservedwithfood	concept-condiment-ginger-sauce
concept-fish-tuna	concept:fishservedwithfood	concept-condiment-mayonnaise
concept-fish-tuna	concept:fishservedwithfood	concept-condiment-ponzu
concept-fish-tuna	concept:fishservedwithfood	concept-condiment-relish
concept-fish-tuna	concept:fishservedwithfood	concept-condiment-salsa
concept-fish-tuna	concept:fishservedwithfood	concept-condiment-wasabi
concept-fish-tuna	concept:fishservedwithfood	concept-food-lunch
concept-fish-tuna	concept:fishservedwithfood	concept-food-salad-recipe
concept-fish-tuna	concept:fishservedwithfood	concept-food-serving
concept-fish-tuna	concept:fishservedwithfood	concept-food-slices
concept-fish-tuna	concept:fishservedwithfood	concept-food-sushi
concept-fish-tuna	concept:fishservedwithfood	concept-grain-management
concept-fish-tuna	concept:fishservedwithfood	concept-meat-dish
concept-fish-tuna	concept:fishservedwithfood	concept-meat-top
concept-fish-tuna	concept:fishservedwithfood	concept-nut-case
concept-fish-tuna	concept:fishservedwithfood	concept-vegetable-cut
concept-fish-tuna	concept:fishservedwithfood	concept-vegetable-dinner
concept-fish-tuna	concept:fishservedwithfood	concept-vegetable-fillet
concept-fish-tuna	concept:fishservedwithfood	concept-visualizablething-cans
concept-fish-tuna	concept:fishservedwithfood	concept-visualizablething-filet
concept-fish-tuna	concept:fishservedwithfood	concept-visualizablething-loin
concept-food-apples	concept:agriculturalproductcamefromcountry	concept-country---america
concept-food-apples	concept:agriculturalproductcutintogeometricshape	concept-geometricshape-cubes
concept-food-apples	concept:agriculturalproductcutintogeometricshape	concept-geometricshape-dice
concept-food-butternut-squash	concept:agriculturalproductcutintogeometricshape	concept-geometricshape-cubes
concept-food-egg	concept:agriculturalproductcutintogeometricshape	concept-geometricshape-cubes
concept-food-eggplant	concept:agriculturalproductcutintogeometricshape	concept-geometricshape-cubes
concept-food-papaya	concept:agriculturalproductcutintogeometricshape	concept-geometricshape-cubes
concept-food-pastures	concept:objectfoundinscene	concept-landscapefeatures-valley
concept-food-pumpkin	concept:agriculturalproductcutintogeometricshape	concept-geometricshape-cubes
concept-food-sushi	concept:foodcancausedisease	concept-disease-food-poisoning
concept-food-sweet-potatoes	concept:agriculturalproductcutintogeometricshape	concept-geometricshape-cubes
concept-food-tofu	concept:agriculturalproductcutintogeometricshape	concept-geometricshape-cubes
concept-fruit-pears	concept:agriculturalproductcutintogeometricshape	concept-geometricshape-dice
concept-furniture-bed	concept:furniturefoundinroom	concept-officebuildingroom-air-conditioned-master-bedroom
concept-furniture-bed	concept:furniturefoundinroom	concept-officebuildingroom-garden-view-room
concept-furniture-bed	concept:furniturefoundinroom	concept-officebuildingroom-lounge-dining-room
concept-furniture-bed	concept:furniturefoundinroom	concept-officebuildingroom-luxury-suites
concept-furniture-bed	concept:furniturefoundinroom	concept-officebuildingroom-master-bedroom-suites
concept-furniture-bed	concept:furniturefoundinroom	concept-officebuildingroom-penthouse-suites
concept-furniture-bed	concept:furniturefoundinroom	concept-officebuildingroom-room-suites
concept-furniture-bed	concept:furniturefoundinroom	concept-officebuildingroom-spacious-main-bedroom
concept-furniture-bed	concept:furniturefoundinroom	concept-officebuildingroom-superior-room
concept-furniture-bed	concept:furniturefoundinroom	concept-officebuildingroom-superior-rooms
concept-furniture-bed	concept:furniturefoundinroom	concept-officebuildingroom-two-bedroom-cottages
concept-furniture-bed	concept:furniturefoundinroom	concept-officebuildingroom-two-guest-bedrooms
concept-furniture-bed	concept:furniturefoundinroom	concept-room-balcony-room
concept-furniture-bed	concept:furniturefoundinroom	concept-room-beautiful-master-bedroom
concept-furniture-bed	concept:furniturefoundinroom	concept-room-beautiful-master-suite
concept-furniture-bed	concept:furniturefoundinroom	concept-room-bed-sitting-room
concept-furniture-bed	concept:furniturefoundinroom	concept-room-connecting-room
concept-furniture-bed	concept:furniturefoundinroom	concept-room-delightful-room
concept-furniture-bed	concept:furniturefoundinroom	concept-room-downstairs-master
concept-furniture-bed	concept:furniturefoundinroom	concept-room-floor-loft
concept-furniture-bed	concept:furniturefoundinroom	concept-room-gardens
concept-furniture-bed	concept:furniturefoundinroom	concept-room-ground-floor-master
concept-furniture-bed	concept:furniturefoundinroom	concept-room-hallway
concept-furniture-bed	concept:furniturefoundinroom	concept-room-large-kitchen
concept-furniture-bed	concept:furniturefoundinroom	concept-room-large-living-dining-room
concept-furniture-bed	concept:furniturefoundinroom	concept-room-large-lounge
concept-furniture-bed	concept:furniturefoundinroom	concept-room-main-suite
concept-furniture-bed	concept:furniturefoundinroom	concept-room-master-bedroom-upstairs
concept-furniture-bed	concept:furniturefoundinroom	concept-room-master-suite-upstairs
concept-furniture-bed	concept:furniturefoundinroom	concept-room-mezzanine-area
concept-furniture-bed	concept:furniturefoundinroom	concept-room-ocean-views
concept-furniture-bed	concept:furniturefoundinroom	concept-room-oversized-master-suite
concept-furniture-bed	concept:furniturefoundinroom	concept-room-presidential-suite
concept-furniture-bed	concept:furniturefoundinroom	concept-room-private-master-bedroom
concept-furniture-bed	concept:furniturefoundinroom	concept-room-regular-room
concept-furniture-bed	concept:furniturefoundinroom	concept-room-roof
concept-furniture-bed	concept:furniturefoundinroom	concept-room-second-guest-room
concept-furniture-bed	concept:furniturefoundinroom	concept-room-separate-lounge
concept-furniture-bed	concept:furniturefoundinroom	concept-room-separate-seating-area
concept-furniture-bed	concept:furniturefoundinroom	concept-room-small-living-room
concept-furniture-bed	concept:furniturefoundinroom	concept-room-small-lounge
concept-furniture-bed	concept:furniturefoundinroom	concept-room-spacious-lounge
concept-furniture-bed	concept:furniturefoundinroom	concept-room-staircase
concept-furniture-bed	concept:furniturefoundinroom	concept-room-studio-bedroom
concept-furniture-bed	concept:furniturefoundinroom	concept-room-third-level
concept-furniture-bed	concept:furniturefoundinroom	concept-visualizablescene-structure
concept-furniture-bed	concept:furniturefoundinroom	concept-visualizablething-green-bedroom
concept-furniture-bed	concept:furniturefoundinroom	concept-visualizablething-guest-bedroom
concept-furniture-bed	concept:furniturefoundinroom	concept-visualizablething-loft-bedroom
concept-furniture-bed	concept:furniturefoundinroom	concept-visualizablething-lower-floor
concept-furniture-bed	concept:furniturefoundinroom	concept-visualizablething-one-suite
concept-furniture-bed	concept:furniturefoundinroom	concept-visualizablething-parlor
concept-furniture-bed	concept:furniturefoundinroom	concept-visualizablething-sixth-bedroom
concept-furniture-bed	concept:furniturefoundinroom	concept-visualizablething-smaller-bedroom
concept-furniture-bed	concept:furniturefoundinroom	concept-visualizablething-third-master-bedroom
concept-furniture-bed	concept:furniturefoundinroom	concept-visualizablething-views
concept-furniture-bunk-beds	concept:furniturefoundinroom	concept-visualizablething-bedrooms
concept-furniture-bunk-beds	concept:furniturefoundinroom	concept-visualizablething-bunk-room
concept-furniture-canopy-beds	concept:furniturefoundinroom	concept-visualizablething-bedrooms
concept-furniture-divan-beds	concept:furniturefoundinroom	concept-visualizablething-bedrooms
concept-furniture-double-wardrobes	concept:furniturefoundinroom	concept-visualizablething-bedrooms
concept-furniture-king-beds	concept:furniturefoundinroom	concept-visualizablething-bedrooms
concept-furniture-log-beds	concept:itemfoundinroom	concept-visualizablething-bedrooms
concept-furniture-queen-beds	concept:furniturefoundinroom	concept-visualizablething-bedrooms
concept-furniture-sleeper-sofa	concept:furniturefoundinroom	concept-visualizablething-bedrooms
concept-furniture-sleeper-sofa	concept:itemfoundinroom	concept-officebuildingroom-great-room
concept-furniture-sofa-bed	concept:itemfoundinroom	concept-visualizableobject-apartment
concept-geometricshape-euclid	concept:atlocation	concept-stateorprovince-ohio
concept-geopoliticallocation-bowling-green	concept:atlocation	concept-stateorprovince-ohio
concept-geopoliticallocation-burma	concept:atdate	concept-date-n1944
concept-geopoliticallocation-kerry	concept:agentcollaborateswithagent	concept-personus-john-edwards
concept-geopoliticallocation-st--charles	concept:proxyfor	concept-company-missouri
concept-geopoliticalorganization-venue	concept:subpartoforganization	concept-terroristorganization-state
concept-governmentorganization-courts	concept:subpartoforganization	concept-terroristorganization-state
concept-governmentorganization-departments	concept:subpartoforganization	concept-terroristorganization-state
concept-governmentorganization-executive-orders	concept:subpartoforganization	concept-terroristorganization-state
concept-governmentorganization-owner	concept:atdate	concept-year-n1919
concept-governmentorganization-program	concept:agentinvolvedwithitem	concept-buildingfeature-window
concept-governmentorganization-rule	concept:subpartoforganization	concept-terroristorganization-state
concept-governmentorganization-standards	concept:subpartoforganization	concept-terroristorganization-state
concept-governmentorganization-techniques	concept:subpartof	concept-weatherphenomenon-air
concept-grain-experience	concept:objectfoundinscene	concept-landscapefeatures-valley
concept-hallwayitem-access	concept:subpartof	concept-hallwayitem-air
concept-hallwayitem-areas	concept:subpartof	concept-hallwayitem-air
concept-hallwayitem-auto	concept:subpartof	concept-hallwayitem-air
concept-hallwayitem-basement	concept:subpartof	concept-hallwayitem-air
concept-hallwayitem-boat	concept:subpartof	concept-hallwayitem-air
concept-hallwayitem-check	concept:subpartof	concept-hallwayitem-air
concept-hallwayitem-console	concept:subpartof	concept-hallwayitem-air
concept-hallwayitem-contact	concept:subpartof	concept-hallwayitem-air
concept-hallwayitem-controls	concept:subpartof	concept-hallwayitem-air
concept-hallwayitem-display	concept:subpartof	concept-hallwayitem-air
concept-hallwayitem-enclosure	concept:subpartof	concept-hallwayitem-air
concept-hallwayitem-interior	concept:subpartof	concept-hallwayitem-air
concept-hallwayitem-market	concept:subpartof	concept-hallwayitem-air
concept-hallwayitem-point	concept:subpartof	concept-hallwayitem-air
concept-hallwayitem-problem	concept:subpartof	concept-hallwayitem-air
concept-hallwayitem-process	concept:subpartof	concept-hallwayitem-air
concept-hallwayitem-refrigerator	concept:subpartof	concept-hallwayitem-air
concept-hallwayitem-solution	concept:subpartof	concept-hallwayitem-air
concept-hallwayitem-tower	concept:subpartof	concept-hallwayitem-air
concept-hallwayitem-van	concept:subpartof	concept-hallwayitem-air
concept-highway-chesterfield	concept:proxyfor	concept-company-missouri
concept-hobby-activities	concept:hobbiessuchashobbies	concept-sport-rafting
concept-hobby-activities	concept:hobbiessuchashobbies	concept-sport-watersports
concept-hobby-fishing	concept:sportfansincountry	concept-country---america
concept-hobby-hiking	concept:sportfansincountry	concept-country---america
concept-hobby-hobbies	concept:hobbiessuchashobbies	concept-sport-soccer
concept-hobby-weight-lifting	concept:sportusesequipment	concept-sportsequipment-equipment
concept-hotel-beau-rivage	concept:hotelincity	concept-city-geneva
concept-hotel-fairmont	concept:atlocation	concept-stateorprovince-west-virginia
concept-hotel-warwick	concept:hotelincity	concept-city-geneva
concept-householditem-bedroom	concept:itemfoundinroom	concept-visualizableobject-apartment
concept-householditem-bedroom	concept:itemfoundinroom	concept-visualizablething-downstairs
concept-householditem-bedroom	concept:itemfoundinroom	concept-visualizablething-lower-floor
concept-householditem-bedroom	concept:subpartof	concept-weatherphenomenon-air
concept-island-british-virgin-islands	concept:countrylocatedingeopoliticallocation	concept-country-countries
concept-island-marshall-islands	concept:atdate	concept-date-n1944
concept-island-marshall-islands	concept:countrylocatedingeopoliticallocation	concept-country-countries
concept-island-mother	concept:atdate	concept-year-n1865
concept-island-truk	concept:atdate	concept-date-n1944
concept-journalist-adam-liptak	concept:worksfor	concept-musicartist-times
concept-journalist-adam-nagourney	concept:personbelongstoorganization	concept-musicartist-times
concept-journalist-alissa-j--rubin	concept:worksfor	concept-musicartist-times
concept-journalist-david-shaw	concept:worksfor	concept-televisionstation-los-angeles-times
concept-journalist-eric-dash	concept:worksfor	concept-musicartist-times
concept-journalist-gina-kolata	concept:personbelongstoorganization	concept-musicartist-times
concept-journalist-howard-rosenberg	concept:worksfor	concept-televisionstation-los-angeles-times
concept-journalist-james-dao	concept:worksfor	concept-musicartist-times
concept-journalist-james-ridgeway	concept:journalistwritesforpublication	concept-politicsblog-village-voice
concept-journalist-jane-brody	concept:worksfor	concept-musicartist-times
concept-journalist-jim-murray	concept:worksfor	concept-televisionstation-los-angeles-times
concept-journalist-john	concept:persondiedatage	2
concept-journalist-kevin-sack	concept:worksfor	concept-musicartist-times
concept-journalist-kurt-eichenwald	concept:worksfor	concept-musicartist-times
concept-journalist-maria	concept:persondiedatage	2
concept-journalist-mike-anderson	concept:worksfor	concept-company-missouri
concept-journalist-nat-hentoff	concept:journalistwritesforpublication	concept-politicsblog-village-voice
concept-journalist-ronald-brownstein	concept:worksfor	concept-televisionstation-los-angeles-times
concept-journalist-sam-dillon	concept:worksfor	concept-musicartist-times
concept-journalist-steven-lee-myers	concept:worksfor	concept-musicartist-times
concept-journalist-tara-parker-pope	concept:worksfor	concept-musicartist-times
concept-journalist-tim-rutten	concept:worksfor	concept-televisionstation-los-angeles-times
concept-judge-personnel	concept:agentbelongstoorganization	concept-terroristorganization-state
concept-lake-atlantic	concept:lakeinstate	concept-stateorprovince-ontario
concept-lake-bay-of-quinte	concept:lakeinstate	concept-stateorprovince-ontario
concept-lake-cayuga-lake	concept:lakeinstate	concept-stateorprovince-ontario
concept-lake-hamilton-harbour	concept:lakeinstate	concept-stateorprovince-ontario
concept-lake-irondequoit-bay	concept:lakeinstate	concept-stateorprovince-ontario
concept-lake-lake-erie	concept:lakeinstate	concept-stateorprovince-ontario
concept-lake-lake-ontario	concept:lakeinstate	concept-stateorprovince-ontario
concept-lake-lower-niagara-river	concept:lakeinstate	concept-stateorprovince-ontario
concept-lake-niagara-river	concept:lakeinstate	concept-stateorprovince-ontario
concept-lake-saint-lawrence	concept:lakeinstate	concept-stateorprovince-ontario
concept-lake-saint-lawrence-river	concept:lakeinstate	concept-stateorprovince-ontario
concept-lake-salmon-river	concept:lakeinstate	concept-stateorprovince-ontario
concept-lake-scarborough-bluffs	concept:lakeinstate	concept-stateorprovince-ontario
concept-lake-sodus-bay	concept:lakeinstate	concept-stateorprovince-ontario
concept-lake-st---lawrence	concept:lakeinstate	concept-stateorprovince-ontario
concept-lake-st---lawrence-river	concept:lakeinstate	concept-stateorprovince-ontario
concept-lake-st---lawrence-seaway	concept:lakeinstate	concept-stateorprovince-ontario
concept-lake-st-lawrence	concept:lakeinstate	concept-stateorprovince-ontario
concept-lake-st-lawrence-river	concept:lakeinstate	concept-stateorprovince-ontario
concept-lake-upper-great-lakes	concept:lakeinstate	concept-stateorprovince-ontario
concept-landscapefeatures-camp	concept:atdate	concept-date-n1944
concept-language-arabic	concept:languageofcountry	concept-country-djibouti
concept-language-arabic	concept:languageofuniversity	concept-university-hebrew-university
concept-language-dutch	concept:languageofcountry	concept-country---america
concept-language-first-english	concept:languageofcountry	concept-country---america
concept-language-french	concept:languageofcountry	concept-country-new-caledonia
concept-language-french	concept:languageofcountry	concept-country-republic
concept-language-french	concept:languageofcountry	concept-country-republic-of-vanuatu
concept-language-french	concept:languageofcountry	concept-country-western-africa
concept-language-french	concept:languageofuniversity	concept-school-columbia
concept-language-french	concept:languageofuniversity	concept-school-oxford
concept-language-french	concept:languageofuniversity	concept-university-catholic-university
concept-language-french	concept:languageofuniversity	concept-university-edinburgh-university
concept-language-french	concept:languageofuniversity	concept-university-oberlin-college
concept-language-french	concept:languageofuniversity	concept-university-stanford-university
concept-language-german	concept:languageofcountry	concept-country-hungary
concept-language-hausa	concept:languageofcountry	concept-country-nigeria
concept-language-hebrew	concept:languageofcountry	concept-country-israel
concept-language-hebrew	concept:languageofuniversity	concept-university-ben-gurion-university
concept-language-hebrew	concept:languageofuniversity	concept-university-haifa-university
concept-language-hebrew	concept:languageofuniversity	concept-university-london-university
concept-language-hebrew	concept:languageofuniversity	concept-university-technion
concept-language-hebrew	concept:languageofuniversity	concept-university-weizmann-institute
concept-language-hebrew	concept:languageofuniversity	concept-university-yeshiva-university
concept-language-latin	concept:languageofuniversity	concept-university-duke-university
concept-language-latin	concept:languageofuniversity	concept-university-stanford-university
concept-language-latin	concept:languageofuniversity	concept-university-uc-berkeley
concept-language-macedonian	concept:languageofcountry	concept-country-republic
concept-language-slavic	concept:languageofcountry	concept-country-macedonia
concept-magazine-bungie	concept:subpartoforganization	concept-university-microsoft
concept-magazine-plans	concept:agentinvolvedwithitem	concept-buildingfeature-window
concept-magazine-story	concept:agentcompeteswithagent	concept-university-search
concept-male-colombia	concept:agentbelongstoorganization	concept-sportsleague-mls
concept-male-isaac	concept:athleteinjuredhisbodypart	concept-braintissue-eyes
concept-male-oct	concept:atdate	concept-date-meeting
concept-meat-bacon	concept:agriculturalproductcutintogeometricshape	concept-geometricshape-bits
concept-meat-beef	concept:agriculturalproductcutintogeometricshape	concept-geometricshape-cubes
concept-meat-chicken	concept:agriculturalproductcutintogeometricshape	concept-geometricshape-cubes
concept-meat-chicken-breast	concept:agriculturalproductcutintogeometricshape	concept-geometricshape-cubes
concept-meat-chicken-breasts	concept:agriculturalproductcutintogeometricshape	concept-geometricshape-cubes
concept-meat-culture	concept:objectfoundinscene	concept-landscapefeatures-valley
concept-meat-ham	concept:agriculturalproductcutintogeometricshape	concept-geometricshape-cubes
concept-meat-pork	concept:agriculturalproductcutintogeometricshape	concept-geometricshape-cubes
concept-meat-salmon	concept:agriculturalproductcutintogeometricshape	concept-geometricshape-dice
concept-meat-steak	concept:agriculturalproductcutintogeometricshape	concept-geometricshape-cubes
concept-medicalprocedure-oct-	concept:atdate	concept-date-community
concept-militaryconflict-paris-peace-conference	concept:atdate	concept-year-n1919
concept-militaryconflict-tobruk	concept:atdate	concept-date-n1941
concept-mlalgorithm-excel	concept:mutualproxyfor	concept-university-microsoft
concept-mlalgorithm-solutions	concept:subpartof	concept-weatherphenomenon-air
concept-mlauthor-papers	concept:agentinvolvedwithitem	concept-buildingfeature-window
concept-mldataset-groups	concept:subpartof	concept-hallwayitem-air
concept-mldataset-jan	concept:atdate	concept-date-community
concept-mldataset-quincy	concept:mutualproxyfor	concept-company-missouri
concept-mldataset-site	concept:subpartof	concept-hallwayitem-air
concept-mldataset-trailer	concept:subpartof	concept-hallwayitem-air
concept-model-magnus	concept:personhascitizenship	concept-country-sweden
concept-mollusk-image-file	concept:agentinvolvedwithitem	concept-buildingfeature-window
concept-monarch-cold-winter	concept:atdate	concept-date-community
concept-month-april	concept:atdate	concept-date-community
concept-month-february	concept:atdate	concept-date-community
concept-month-january	concept:atdate	concept-date-community
concept-month-march	concept:atdate	concept-date-community
concept-month-september	concept:atdate	concept-date-community
concept-month-september	concept:atdate	concept-date-meeting
concept-mountain-allegheny-mountains	concept:mountaininstate	concept-stateorprovince-virginia
concept-mountain-beautiful-appalachian-mountains	concept:mountaininstate	concept-stateorprovince-virginia
concept-mountain-campbell-hill	concept:mountaininstate	concept-stateorprovince-ohio
concept-mountain-mount-miserable	concept:mountaininstate	concept-stateorprovince-ohio
concept-mountain-mount-rogers	concept:mountaininstate	concept-stateorprovince-virginia
concept-mountain-spruce-knob	concept:mountaininstate	concept-stateorprovince-west-virginia
concept-museum-steve	concept:proxyfor	concept-university-microsoft
concept-musicalbum-events	concept:atdate	concept-date-n1944
concept-musicalbum-hermann	concept:proxyfor	concept-company-missouri
concept-musicalbum-invasion	concept:atdate	concept-date-n1941
concept-musicalbum-liberation	concept:atdate	concept-date-n1944
concept-musicalbum-today	concept:atdate	concept-date-community
concept-musicalbum-tomorrow	concept:atdate	concept-date-community
concept-musicalbum-winter	concept:atdate	concept-date-meeting
concept-musicartist-bottom	concept:agentinvolvedwithitem	concept-buildingfeature-window
concept-musicartist-load	concept:agentinvolvedwithitem	concept-buildingfeature-window
concept-musicartist-offensive	concept:atdate	concept-date-n1944
concept-musicartist-session	concept:atdate	concept-year-n1946
concept-musicartist-takeo-fukui	concept:agentcontrols	concept-automobilemaker-honda
concept-musicartist-times	concept:agentactsinlocation	concept-city-baghdad
concept-musicartist-times	concept:agentactsinlocation	concept-city-l-a-
concept-musicartist-times	concept:agentactsinlocation	concept-country-scandinavia
concept-musicartist-times	concept:agentcollaborateswithagent	concept-blog-paul-krugman
concept-musicartist-times	concept:agentcollaborateswithagent	concept-journalist-john-markoff
concept-musicartist-times	concept:agentcollaborateswithagent	concept-journalist-maureen-dowd
concept-musicartist-times	concept:agentcollaborateswithagent	concept-journalist-nicholas-kristof
concept-musicartist-times	concept:agentinvolvedwithitem	concept-buildingfeature-window
concept-musicartist-times	concept:agentinvolvedwithitem	concept-buildingfeature-windows
concept-musicartist-times	concept:organizationdissolvedatdate	concept-month-june
concept-musicartist-times	concept:organizationdissolvedatdate	concept-month-october
concept-musicartist-type	concept:agentinvolvedwithitem	concept-buildingfeature-window
concept-musician-john	concept:persondiedatage	2
concept-musician-justin	concept:persondiedatage	20
concept-musician-studio	concept:agentbelongstoorganization	concept-terroristorganization-state
concept-musicinstrument-base	concept:objectfoundinscene	concept-landscapefeatures-valley
concept-musicinstrument-photo	concept:objectfoundinscene	concept-landscapefeatures-valley
concept-musicsong-mediterranean	concept:atdate	concept-date-n1941
concept-musicsong-summer	concept:atdate	concept-date-meeting
concept-newspaper-kgw-tv	concept:subpartof	concept-retailstore-nbc
concept-newspaper-krnv-tv	concept:subpartof	concept-retailstore-nbc
concept-newspaper-wowt	concept:subpartof	concept-retailstore-nbc
concept-nondiseasecondition-condo	concept:subpartof	concept-hallwayitem-air
concept-nondiseasecondition-discharge	concept:atdate	concept-year-n1946
concept-nongovorganization-information	concept:agentbelongstoorganization	concept-governmentorganization-governments
concept-nongovorganization-information	concept:agentcollaborateswithagent	concept-person-government
concept-nongovorganization-information	concept:agentcollaborateswithagent	concept-terroristorganization-state
concept-nongovorganization-information	concept:agentcreated	concept-academicfield-history-contact
concept-nongovorganization-information	concept:agentcreated	concept-aquarium-u-s--contact
concept-nongovorganization-information	concept:agentcreated	concept-ceo-business-contact
concept-nongovorganization-information	concept:agentcreated	concept-ceo-sale-contact
concept-nongovorganization-information	concept:agentcreated	concept-criminal-links-contact
concept-nongovorganization-information	concept:agentcreated	concept-eventoutcome-more-contact
concept-nongovorganization-information	concept:agentcreated	concept-mlarea-call
concept-nongovorganization-information	concept:agentcreated	concept-musicsong-questions-contact
concept-nongovorganization-information	concept:agentcreated	concept-personasia-share-email
concept-nongovorganization-information	concept:agentcreated	concept-scientificterm-info-contact
concept-nongovorganization-information	concept:agentcreated	concept-scientificterm-information-click
concept-nongovorganization-information	concept:agentcreated	concept-stateorprovince-mailing
concept-nongovorganization-information	concept:agentcreated	concept-weapon-course
concept-nongovorganization-representatives	concept:agentbelongstoorganization	concept-terroristorganization-state
concept-nongovorganization-u-s--navy	concept:atdate	concept-date-n1941
concept-nonneginteger-one	concept:atdate	concept-date-community
concept-nut-wall	concept:objectfoundinscene	concept-landscapefeatures-valley
concept-organization-colombia	concept:hasofficeincountry	concept-country---america
concept-organization-league-of-nations	concept:organizationheadquarteredincity	concept-city-geneva
concept-organization-lehman-brothers-holdings-inc--	concept:subpartoforganization	concept-bank-barclays
concept-organization-mtctechnologies	concept:organizationheadquarteredinstateorprovince	concept-stateorprovince-ohio
concept-park-first-friday	concept:atdate	concept-date-meeting
concept-park-n1	concept:atdate	concept-date-community
concept-person-abbas	concept:agentcontrols	concept-agent-security-forces
concept-person-abbas	concept:personleadsorganization	concept-bank-administration
concept-person-abbas	concept:personleadsorganization	concept-biotechcompany-pa
concept-person-abbas	concept:personleadsorganization	concept-company-credibility
concept-person-abbas	concept:personleadsorganization	concept-country-party
concept-person-abbas	concept:personleadsorganization	concept-governmentorganization-rule
concept-person-abbas	concept:personleadsorganization	concept-musicartist-faction
concept-person-abbas	concept:personleadsorganization	concept-nongovorganization-fatah-leadership
concept-person-abbas	concept:personleadsorganization	concept-nongovorganization-rival-fatah
concept-person-abbas	concept:personleadsorganization	concept-politicalparty-moderates
concept-person-abbas	concept:personleadsorganization	concept-politicalparty-movement
concept-person-abbas	concept:personleadsorganization	concept-politicalparty-palestine-authority
concept-person-abbas	concept:personleadsorganization	concept-politicalparty-palestinian-national-authority
concept-person-abbas	concept:personleadsorganization	concept-terroristorganization-fatah-faction
concept-person-abbas	concept:personleadsorganization	concept-terroristorganization-fatah-forces
concept-person-abbas	concept:personleadsorganization	concept-terroristorganization-fatah-movement
concept-person-abbas	concept:personleadsorganization	concept-terroristorganization-fatah-party
concept-person-abbas	concept:personleadsorganization	concept-terroristorganization-fatah-security-forces
concept-person-abbas	concept:personleadsorganization	concept-terroristorganization-fateh
concept-person-abbas	concept:personleadsorganization	concept-terroristorganization-moderate-fatah-party
concept-person-abbas	concept:personleadsorganization	concept-terroristorganization-palestinian-authority
concept-person-abbas	concept:personleadsorganization	concept-terroristorganization-palestinian-government
concept-person-abbas	concept:personleadsorganization	concept-terroristorganization-palestinian-leadership
concept-person-abbas	concept:personleadsorganization	concept-terroristorganization-plo
concept-person-abbas	concept:personleadsorganization	concept-terroristorganization-rival-fatah-faction
concept-person-abbas	concept:personleadsorganization	concept-terroristorganization-rival-fatah-movement
concept-person-abbas	concept:personleadsorganization	concept-terroristorganization-rival-fatah-party
concept-person-abbas	concept:personleadsorganization	concept-terroristorganization-secular-fatah-faction
concept-person-abbas	concept:personleadsorganization	concept-terroristorganization-west-bank
concept-person-abbas	concept:personleadsorganization	concept-terroristorganization-wing
concept-person-abbas	concept:personleadsorganization	concept-tradeunion-security
concept-person-abdullah-ocalan	concept:personhasjobposition	concept-jobposition-leader
concept-person-al001	concept:personborninlocation	concept-county-york-city
concept-person-alan	concept:personborninlocation	concept-county-york-city
concept-person-alex001	concept:persondiedatage	2
concept-person-andrea	concept:personborninlocation	concept-county-york-city
concept-person-annie	concept:personborninlocation	concept-county-york-city
concept-person-arnaldo-otegi	concept:personhasjobposition	concept-jobposition-leader
concept-person-arthur	concept:personborninlocation	concept-county-york-city
concept-person-ben-silverman	concept:agentcontrols	concept-retailstore-nbc
concept-person-benjamin	concept:persondiedatage	2
concept-person-bob-wright	concept:agentcontrols	concept-retailstore-nbc
concept-person-bob-wright001	concept:subpartof	concept-retailstore-nbc
concept-person-brooke	concept:personborninlocation	concept-county-york-city
concept-person-c	concept:persondiedatage	2
concept-person-carl	concept:personhascitizenship	concept-country-sweden
concept-person-charles001	concept:personhascitizenship	concept-country-hungary
concept-person-claire	concept:personborninlocation	concept-county-york-city
concept-person-d	concept:persondiedatage	2
concept-person-danielle	concept:personborninlocation	concept-county-york-city
concept-person-data	concept:agentinvolvedwithitem	concept-buildingfeature-window
concept-person-david	concept:personhascitizenship	concept-country-scotland
concept-person-diane001	concept:personborninlocation	concept-county-york-city
concept-person-doug	concept:personborninlocation	concept-county-york-city
concept-person-edward001	concept:personborninlocation	concept-county-york-city
concept-person-edward001	concept:personhascitizenship	concept-country-scotland
concept-person-elizabeth001	concept:hasspouse	concept-politicianus-henry
concept-person-elizabeth001	concept:personborninlocation	concept-county-york-city
concept-person-eric	concept:persondiedatage	2
concept-person-eric	concept:personhascitizenship	concept-country-sweden
concept-person-gardner	concept:persondiedatage	2
concept-person-gene	concept:personborninlocation	concept-county-york-city
concept-person-george001	concept:persondiedatage	2
concept-person-george002	concept:persondiedatage	2
concept-person-goodman	concept:personborninlocation	concept-county-york-city
concept-person-grant	concept:persondiedatage	2
concept-person-grant001	concept:personborninlocation	concept-county-york-city
concept-person-grant002	concept:persondiedatage	2
concept-person-gustaf	concept:personhascitizenship	concept-country-sweden
concept-person-hi	concept:persondiedatage	2
concept-person-hitler	concept:atdate	concept-date-n1941
concept-person-home001	concept:agentcollaborateswithagent	concept-musicartist-times
concept-person-hurston	concept:personborninlocation	concept-county-york-city
concept-person-jack001	concept:persondiedatage	2
concept-person-jack002	concept:persondiedatage	2
concept-person-jennifer001	concept:personborninlocation	concept-county-york-city
concept-person-joey	concept:persondiedatage	2
concept-person-joey001	concept:persondiedatage	2
concept-person-john002	concept:persondiedatage	2
concept-person-justin	concept:personborninlocation	concept-county-york-city
concept-person-justin	concept:persondiedatage	20
concept-person-karl	concept:personhascitizenship	concept-country-sweden
concept-person-ken	concept:persondiedatage	2
concept-person-kevin001	concept:persondiedatage	2
concept-person-king	concept:personhascitizenship	concept-country-sweden
concept-person-larry	concept:personborninlocation	concept-county-york-city
concept-person-lauren	concept:personborninlocation	concept-county-york-city
concept-person-lee	concept:persondiedatage	2
concept-person-lehman	concept:agentcontrols	concept-person-philippe-burke
concept-person-lehman	concept:subpartof	concept-bank-barclays
concept-person-lewis001	concept:personborninlocation	concept-county-york-city
concept-person-lisa001	concept:personmovedtostateorprovince	concept-stateorprovince-virginia
concept-person-lori	concept:personborninlocation	concept-county-york-city
concept-person-maria	concept:persondiedatage	2
concept-person-martin002	concept:personborninlocation	concept-county-york-city
concept-person-mason	concept:personborninlocation	concept-county-york-city
concept-person-matt001	concept:persondiedatage	2
concept-person-matt002	concept:personborninlocation	concept-county-york-city
concept-person-matthew	concept:personborninlocation	concept-county-york-city
concept-person-max	concept:persondiedatage	2
concept-person-max002	concept:persondiedatage	2
concept-person-michael002	concept:parentofperson	concept-person-jesus
concept-person-michael002	concept:persongraduatedfromuniversity	concept-university-stanford-university
concept-person-mitchell	concept:personborninlocation	concept-county-york-city
concept-person-monroe	concept:personborninlocation	concept-county-york-city
concept-person-morgan	concept:personborninlocation	concept-county-york-city
concept-person-mukwege	concept:personhasresidenceingeopoliticallocation	concept-country-democratic-republic-of-congo
concept-person-nikki	concept:persondiedatage	2
concept-person-oh002	concept:persondiedatage	2
concept-person-otis	concept:personborninlocation	concept-county-york-city
concept-person-patricia	concept:personborninlocation	concept-county-york-city
concept-person-patrick	concept:personborninlocation	concept-county-york-city
concept-person-prince	concept:personhascitizenship	concept-country-wales
concept-person-princess	concept:personhascitizenship	concept-country-wales
concept-person-queen	concept:personhascitizenship	concept-country-hungary
concept-person-reynolds	concept:personborninlocation	concept-county-york-city
concept-person-richard001	concept:persondiedatage	2
concept-person-richard002	concept:persondiedatage	2
concept-person-richard004	concept:persondiedatage	2
concept-person-robbie-bach	concept:personleadsorganization	concept-university-microsoft
concept-person-robert001	concept:persondiedatage	2
concept-person-ross	concept:personborninlocation	concept-county-york-city
concept-person-sarah	concept:persondiedatage	2
concept-person-sean002	concept:personborninlocation	concept-county-york-city
concept-person-sherman	concept:personborninlocation	concept-county-york-city
concept-person-susan	concept:personborninlocation	concept-county-york-city
concept-person-tara	concept:personborninlocation	concept-county-york-city
concept-person-tebow	concept:athleteplayssportsteamposition	concept-sportsteamposition-player
concept-person-tebow	concept:personalsoknownas	concept-athlete-tim-tebow
concept-person-technology	concept:agentbelongstoorganization	concept-terroristorganization-state
concept-person-thich-nhat-hanh	concept:personhasjobposition	concept-jobposition-leader
concept-person-tony	concept:persondiedatage	2
concept-person-torres	concept:personborninlocation	concept-county-york-city
concept-person-tyler001	concept:personborninlocation	concept-county-york-city
concept-person-vincent	concept:personborninlocation	concept-county-york-city
concept-person-wales	concept:agentbelongstoorganization	concept-sportsleague-mls
concept-person-wayne	concept:persondiedatage	20
concept-person-wayne001	concept:persondiedatage	20
concept-person-zachary	concept:personborninlocation	concept-county-york-city
concept-person-zaddick-elimelech-weissblum	concept:personhasjobposition	concept-jobposition-leader
concept-personafrica-tom-brokaw	concept:subpartof	concept-retailstore-nbc
concept-personalcareitem-children	concept:objectfoundinscene	concept-landscapefeatures-valley
concept-personalcareitem-development	concept:objectfoundinscene	concept-landscapefeatures-valley
concept-personalcareitem-maps	concept:objectfoundinscene	concept-landscapefeatures-valley
concept-personalcareitem-nature	concept:objectfoundinscene	concept-landscapefeatures-valley
concept-personasia-koti	concept:subpartof	concept-retailstore-nbc
concept-personasia-songs	concept:agentinvolvedwithitem	concept-buildingfeature-window
concept-personaustralia-david-nagel	concept:personleadsorganization	concept-company-palmsource
concept-personaustralia-edmund-l--andrews	concept:worksfor	concept-musicartist-times
concept-personaustralia-kris-boyd	concept:athletehomestadium	concept-stadiumoreventvenue-giants-stadium
concept-personaustralia-michael	concept:athleteplayssportsteamposition	concept-sportsteamposition-player
concept-personaustralia-more-information	concept:agentinvolvedwithitem	concept-buildingfeature-window
concept-personaustralia-paul-allen	concept:worksfor	concept-university-microsoft
concept-personcanada-roberta-smith	concept:worksfor	concept-musicartist-times
concept-personcanada-search-form	concept:agentinvolvedwithitem	concept-buildingfeature-window
concept-personcanada-slideshow	concept:agentinvolvedwithitem	concept-buildingfeature-window
concept-personeurope-david-beckham	concept:athleteplayssport	concept-sport-soccer
concept-personeurope-federer	concept:athletewinsawardtrophytournament	concept-awardtrophytournament-australian-open
concept-personeurope-fulton	concept:proxyfor	concept-company-missouri
concept-personeurope-isabella	concept:personhascitizenship	concept-country-spain
concept-personeurope-order	concept:agentinvolvedwithitem	concept-buildingfeature-window
concept-personeurope-richard-branson	concept:persondiedatage	2
concept-personeurope-robert	concept:persondiedatage	2
concept-personeurope-steven-greenhouse	concept:worksfor	concept-musicartist-times
concept-personeurope-whitney	concept:subpartof	concept-county-york-city
concept-personmexico-brian-leetch	concept:athletehomestadium	concept-stadiumoreventvenue-giants-stadium
concept-personmexico-chris-perez	concept:athletehomestadium	concept-stadiumoreventvenue-giants-stadium
concept-personmexico-david-tyree	concept:athletehomestadium	concept-stadiumoreventvenue-giants-stadium
concept-personmexico-eli-marrero	concept:athletehomestadium	concept-stadiumoreventvenue-giants-stadium
concept-personmexico-frank-francisco	concept:athletehomestadium	concept-stadiumoreventvenue-giants-stadium
concept-personmexico-herschel-walker	concept:athleteplayssportsteamposition	concept-sportsteamposition-running-back
concept-personmexico-jason-taylor	concept:athletehomestadium	concept-stadiumoreventvenue-giants-stadium
concept-personmexico-joe-montana	concept:athleteplayssportsteamposition	concept-sportsteamposition-player
concept-personmexico-john-riggins	concept:athleteplayssportsteamposition	concept-sportsteamposition-running-back
concept-personmexico-jose-castillo	concept:athletehomestadium	concept-stadiumoreventvenue-giants-stadium
concept-personnorthamerica-puerto-rico	concept:agentbelongstoorganization	concept-sportsleague-mls
concept-personnorthamerica-reed	concept:personborninlocation	concept-county-york-city
concept-personnorthamerica-venezuela	concept:agentbelongstoorganization	concept-sportsleague-mls
concept-personus-access	concept:agentinvolvedwithitem	concept-buildingfeature-window
concept-personus-access	concept:subpartof	concept-company-palmsource
concept-personus-gould	concept:personborninlocation	concept-county-york-city
concept-personus-henry	concept:persondiedatage	2
concept-personus-jeremy-shockey	concept:athleteplayssportsteamposition	concept-sportsteamposition-player
concept-personus-kate-zernike	concept:worksfor	concept-musicartist-times
concept-personus-kobe-bryant	concept:athleteplayssportsteamposition	concept-sportsteamposition-player
concept-personus-media	concept:agentinvolvedwithitem	concept-buildingfeature-window
concept-personus-miller	concept:athleteinjuredhisbodypart	concept-bodypart-hands
concept-personus-miller	concept:athleteplayssportsteamposition	concept-sportsteamposition-player
concept-personus-paul-allen	concept:subpartof	concept-university-microsoft
concept-politicalparty-process	concept:subpartoforganization	concept-terroristorganization-state
concept-politicalparty-republic	concept:atdate	concept-year-n1946
concept-politicalparty-republic	concept:synonymfor	concept-country-rwanda
concept-politician-sites	concept:agentbelongstoorganization	concept-terroristorganization-state
concept-politicianus-earl-ray-tomblin	concept:personhasresidenceingeopoliticallocation	concept-stateorprovince-west-virginia
concept-politicianus-ellison	concept:personborninlocation	concept-county-york-city
concept-politicianus-fund	concept:agentbelongstoorganization	concept-terroristorganization-state
concept-politicianus-george-voinovich	concept:politicianrepresentslocation	concept-stateorprovince-ohio
concept-politicianus-henry	concept:personborninlocation	concept-county-york-city
concept-politicianus-henry	concept:personhasjobposition	concept-jobposition-leader
concept-politicianus-jim	concept:persondiedatage	2
concept-politicianus-mikhail-gorbachev	concept:personleadsorganization	concept-organization-soviet
concept-politicianus-robert	concept:persondiedatage	2
concept-politicsblog-chart	concept:agentinvolvedwithitem	concept-buildingfeature-window
concept-politicsblog-network	concept:agentcompeteswithagent	concept-university-search
concept-politicsblog-presence	concept:subpartoforganization	concept-terroristorganization-state
concept-politicsissue-age	concept:atdate	concept-date-community
concept-politicsissue-strike	concept:atdate	concept-year-n1946
concept-profession-atlantic	concept:atdate	concept-date-n1941
concept-profession-development	concept:professionusestool	concept-sportsequipment-equipment
concept-profession-number	concept:professionusestool	concept-sportsequipment-equipment
concept-profession-number	concept:professionusestool	concept-tool-tools
concept-profession-practitioners	concept:professionistypeofprofession	concept-profession-individuals
concept-profession-prices	concept:professionusestool	concept-tool-accessories
concept-profession-soldiers	concept:atdate	concept-date-n1944
concept-professor-james-reston	concept:worksfor	concept-musicartist-times
concept-professor-mark-bittman	concept:personbelongstoorganization	concept-musicartist-times
concept-programminglanguage-command	concept:atdate	concept-date-n1941
concept-programminglanguage-main	concept:atdate	concept-date-community
concept-protein-raf	concept:atdate	concept-date-n1941
concept-publication-wsaz-tv	concept:subpartof	concept-retailstore-nbc
concept-radiostation-kfai	concept:radiostationincity	concept-city-minneapolis
concept-radiostation-kgmi	concept:radiostationincity	concept-city-bellingham
concept-radiostation-kxcv	concept:radiostationincity	concept-city-maryville
concept-radiostation-kzaz	concept:radiostationincity	concept-city-bellingham
concept-radiostation-nevada	concept:companyeconomicsector	concept-economicsector-insurance-coverage
concept-radiostation-puerto-rico	concept:hasofficeincountry	concept-country---america
concept-religion-world-war-ii	concept:atdate	concept-date-n1941
concept-river-atchafalaya	concept:riveremptiesintoriver	concept-river-mississippi-river
concept-river-gila	concept:riveremptiesintoriver	concept-river-colorado-river
concept-river-gila	concept:riveremptiesintoriver	concept-river-salt-river
concept-river-illinois-river	concept:riveremptiesintoriver	concept-river-mississippi-river
concept-river-mississippi-river	concept:riveremptiesintoriver	concept-river-arkansas-river
concept-river-mississippi-river	concept:riveremptiesintoriver	concept-river-red-river
concept-river-mississippi-river	concept:riveremptiesintoriver	concept-river-wisconsin-river
concept-river-missouri-river	concept:riveremptiesintoriver	concept-river-mississippi-river
concept-river-yellowstone	concept:riveremptiesintoriver	concept-river-missouri-river
concept-roadaccidentevent-p-m--saturday	concept:atdate	concept-date-community
concept-roadaccidentevent-p-m--sunday	concept:atdate	concept-date-community
concept-room-plan	concept:subpartof	concept-weatherphenomenon-air
concept-room-properties	concept:subpartof	concept-weatherphenomenon-air
concept-scientist-mikhail-gorbachev	concept:personhasjobposition	concept-jobposition-leader
concept-scientist-mikhail-gorbachev	concept:worksfor	concept-organization-soviet
concept-scientist-yasser-arafat	concept:personhasjobposition	concept-jobposition-leader
concept-shoppingmall-columbia	concept:locationlocatedwithinlocation	concept-stateorprovince-maryland
concept-skiarea-southeastern	concept:mutualproxyfor	concept-company-missouri
concept-software-system-design	concept:subpartof	concept-hallwayitem-air
concept-software-system-works	concept:subpartof	concept-hallwayitem-air
concept-sport-badminton	concept:sportusesequipment	concept-sportsequipment-net
concept-sport-bass-fishing	concept:sportusesequipment	concept-sportsequipment-equipment
concept-sport-billiard	concept:sportusesequipment	concept-tool-accessories
concept-sport-billiards	concept:sportusesequipment	concept-tool-accessories
concept-sport-boat	concept:sportusesequipment	concept-tool-accessories
concept-sport-boating	concept:sportfansincountry	concept-country---america
concept-sport-bowling	concept:sportusesequipment	concept-sportsequipment-bowling-shoes
concept-sport-bowling	concept:sportusesequipment	concept-sportsequipment-pin
concept-sport-bowling	concept:sportusesequipment	concept-sportsequipment-pins
concept-sport-bowling	concept:sportusesequipment	concept-tool-accessories
concept-sport-boxing	concept:sportusesequipment	concept-sportsequipment-boxing-gloves
concept-sport-boxing	concept:sportusesequipment	concept-sportsequipment-equipment
concept-sport-club	concept:sportfansincountry	concept-country---america
concept-sport-college-football	concept:sportusesequipment	concept-sportsequipment-football
concept-sport-croquet	concept:sportusesequipment	concept-sportsequipment-ball
concept-sport-cycling	concept:sportschoolincountry	concept-country---america
concept-sport-dance	concept:sportschoolincountry	concept-country-uk
concept-sport-first-golf	concept:sportschoolincountry	concept-country---america
concept-sport-fitness	concept:sportfansincountry	concept-country---america
concept-sport-fly-fishing	concept:sportfansincountry	concept-country---america
concept-sport-golfing	concept:sportfansincountry	concept-country---america
concept-sport-great-golf	concept:sportusesequipment	concept-tool-accessories
concept-sport-gymnastics	concept:sportusesequipment	concept-sportsequipment-equipment
concept-sport-hunting	concept:sportfansincountry	concept-country---america
concept-sport-ice-hockey	concept:sportfansincountry	concept-country---america
concept-sport-judo	concept:sportfansincountry	concept-country-japan
concept-sport-kayak	concept:sportfansincountry	concept-country---america
concept-sport-ladies-golf	concept:sportusesequipment	concept-tool-accessories
concept-sport-major-sports	concept:sportschoolincountry	concept-country---america
concept-sport-outdoor	concept:sportusesequipment	concept-sportsequipment-equipment
concept-sport-paddling	concept:sportusesequipment	concept-sportsequipment-equipment
concept-sport-paintball	concept:sportusesequipment	concept-tool-accessories
concept-sport-pool	concept:sportusesequipment	concept-tool-accessories
concept-sport-racing	concept:sportfansincountry	concept-country---america
concept-sport-racquetball	concept:sportusesequipment	concept-sportsequipment-ball
concept-sport-rafting	concept:sportfansincountry	concept-country---america
concept-sport-rock-climbing	concept:sportusesequipment	concept-sportsequipment-equipment
concept-sport-rugby	concept:sportfansincountry	concept-country---america
concept-sport-rugby	concept:sporthassportsteamposition	concept-sportsteamposition-player
concept-sport-sailing	concept:sportschoolincountry	concept-country---america
concept-sport-scuba	concept:sportusesequipment	concept-sportsequipment-equipment
concept-sport-scuba-diving	concept:sportschoolincountry	concept-country---america
concept-sport-shooting	concept:sportusesequipment	concept-tool-accessories
concept-sport-ski	concept:sportschoolincountry	concept-country---america
concept-sport-skiing	concept:sportfansincountry	concept-country---america
concept-sport-snooker	concept:sportusesequipment	concept-tool-accessories
concept-sport-snorkeling	concept:sportusesequipment	concept-sportsequipment-equipment
concept-sport-snowboard	concept:sportfansincountry	concept-country---america
concept-sport-snowboarding	concept:sportfansincountry	concept-country---america
concept-sport-soccer	concept:sportfansincountry	concept-country---america
concept-sport-soccer	concept:sportfansincountry	concept-country-japan
concept-sport-soccer	concept:sportusesequipment	concept-sportsequipment-apparel
concept-sport-soccer	concept:sportusesequipment	concept-sportsequipment-bag
concept-sport-soccer	concept:sportusesequipment	concept-sportsequipment-ball
concept-sport-soccer	concept:sportusesequipment	concept-sportsequipment-balls
concept-sport-soccer	concept:sportusesequipment	concept-sportsequipment-cleats
concept-sport-soccer	concept:sportusesequipment	concept-sportsequipment-cones
concept-sport-soccer	concept:sportusesequipment	concept-sportsequipment-equipment
concept-sport-soccer	concept:sportusesequipment	concept-sportsequipment-football
concept-sport-soccer	concept:sportusesequipment	concept-sportsequipment-footwear
concept-sport-soccer	concept:sportusesequipment	concept-sportsequipment-gear
concept-sport-soccer	concept:sportusesequipment	concept-sportsequipment-goal
concept-sport-soccer	concept:sportusesequipment	concept-sportsequipment-goals
concept-sport-soccer	concept:sportusesequipment	concept-sportsequipment-jersey
concept-sport-soccer	concept:sportusesequipment	concept-sportsequipment-jerseys
concept-sport-soccer	concept:sportusesequipment	concept-sportsequipment-net
concept-sport-soccer	concept:sportusesequipment	concept-sportsequipment-nets
concept-sport-soccer	concept:sportusesequipment	concept-sportsequipment-shin-guards
concept-sport-soccer	concept:sportusesequipment	concept-sportsequipment-shinguards
concept-sport-soccer	concept:sportusesequipment	concept-sportsequipment-soccer-accessories
concept-sport-soccer	concept:sportusesequipment	concept-sportsequipment-soccer-ball
concept-sport-soccer	concept:sportusesequipment	concept-sportsequipment-soccer-balls
concept-sport-soccer	concept:sportusesequipment	concept-sportsequipment-soccer-cleats
concept-sport-soccer	concept:sportusesequipment	concept-sportsequipment-soccer-equipment
concept-sport-soccer	concept:sportusesequipment	concept-sportsequipment-soccer-shoes
concept-sport-soccer	concept:sportusesequipment	concept-sportsequipment-softball
concept-sport-soccer	concept:sportusesequipment	concept-sportsequipment-tennis-balls
concept-sport-soccer	concept:sportusesequipment	concept-sportsequipment-top
concept-sport-soccer	concept:sportusesequipment	concept-sportsequipment-uniforms
concept-sport-soccer	concept:sportusesequipment	concept-sportsequipment-volley-ball
concept-sport-soccer	concept:sportusesequipment	concept-visualizablething-toys
concept-sport-soccer	concept:sportusesstadium	concept-stadiumoreventvenue-wembley-stadium
concept-sport-softball	concept:sportusesequipment	concept-tool-accessories
concept-sport-sport-fishing	concept:sportfansincountry	concept-country---america
concept-sport-sports	concept:sportschoolincountry	concept-country---america
concept-sport-squash	concept:sportusesequipment	concept-tool-accessories
concept-sport-surf	concept:sportschoolincountry	concept-country---america
concept-sport-surfing	concept:sportschoolincountry	concept-country---america
concept-sport-surfing	concept:sportusesequipment	concept-tool-accessories
concept-sport-table-tennis	concept:sportusesequipment	concept-sportsequipment-balls
concept-sport-team	concept:sportusesequipment	concept-tool-accessories
concept-sport-tennis	concept:sportfansincountry	concept-country---america
concept-sport-tennis	concept:sportusesequipment	concept-software-system
concept-sport-tennis	concept:sportusesequipment	concept-sportsequipment-area
concept-sport-tennis	concept:sportusesequipment	concept-sportsequipment-bags
concept-sport-tennis	concept:sportusesequipment	concept-sportsequipment-baseball-bat
concept-sport-tennis	concept:sportusesequipment	concept-sportsequipment-baseballs
concept-sport-tennis	concept:sportusesequipment	concept-sportsequipment-bat
concept-sport-tennis	concept:sportusesequipment	concept-sportsequipment-clubs
concept-sport-tennis	concept:sportusesequipment	concept-sportsequipment-footballs
concept-sport-tennis	concept:sportusesequipment	concept-sportsequipment-golf-ball
concept-sport-tennis	concept:sportusesequipment	concept-sportsequipment-golf-club
concept-sport-tennis	concept:sportusesequipment	concept-sportsequipment-hockey-sticks
concept-sport-tennis	concept:sportusesequipment	concept-sportsequipment-part
concept-sport-tennis	concept:sportusesequipment	concept-sportsequipment-racket
concept-sport-tennis	concept:sportusesequipment	concept-sportsequipment-rope
concept-sport-tennis	concept:sportusesequipment	concept-sportsequipment-set
concept-sport-tennis	concept:sportusesequipment	concept-sportsequipment-skis
concept-sport-tennis	concept:sportusesequipment	concept-sportsequipment-sock
concept-sport-tennis	concept:sportusesequipment	concept-sportsequipment-string
concept-sport-tennis	concept:sportusesequipment	concept-sportsequipment-supplies
concept-sport-tennis	concept:sportusesequipment	concept-sportsequipment-tennis-ball
concept-sport-tennis	concept:sportusesequipment	concept-sportsequipment-tennis-racket
concept-sport-tennis	concept:sportusesequipment	concept-sportsequipment-tennis-rackets
concept-sport-tennis	concept:sportusesequipment	concept-sportsequipment-tennis-racquets
concept-sport-tennis	concept:sportusesequipment	concept-sportsequipment-tennis-shoes
concept-sport-tennis	concept:sportusesequipment	concept-tool-grips
concept-sport-tennis	concept:sportusesequipment	concept-tool-lights
concept-sport-tennis	concept:sportusesstadium	concept-stadiumoreventvenue-arthur-ashe-stadium
concept-sport-tennis	concept:sportusesstadium	concept-stadiumoreventvenue-centre-court
concept-sport-track	concept:sportschoolincountry	concept-country---america
concept-sport-triathlon	concept:sportfansincountry	concept-country---america
concept-sport-unique-golf	concept:sportusesequipment	concept-tool-accessories
concept-sport-volleyball	concept:sportusesequipment	concept-tool-accessories
concept-sport-wakeboard	concept:sportusesequipment	concept-sportsequipment-equipment
concept-sport-water-ski	concept:sportusesequipment	concept-sportsequipment-equipment
concept-sport-water-sports	concept:hobbiessuchashobbies	concept-sport-rafting
concept-sport-water-sports	concept:sportusesequipment	concept-sportsequipment-kayaks
concept-sport-winter-sports	concept:sportusesequipment	concept-sportsequipment-equipment
concept-sport-yoga	concept:sportusesequipment	concept-tool-accessories
concept-sport-youth-hockey	concept:sportschoolincountry	concept-country---america
concept-sport-youth-soccer	concept:sportfansincountry	concept-country---america
concept-sportsequipment-equipment-manufacturers	concept:subpartof	concept-hallwayitem-air
concept-sportsequipment-northwest	concept:objectfoundinscene	concept-landscapefeatures-valley
concept-sportsequipment-officials	concept:subpartof	concept-hallwayitem-air
concept-sportsequipment-rim	concept:objectfoundinscene	concept-landscapefeatures-valley
concept-sportsequipment-west	concept:objectfoundinscene	concept-landscapefeatures-valley
concept-sportsgame-n1998-wimbledon-championship	concept:sportsgamesport	concept-sport-tennis
concept-sportsgame-n2000-euro-cup	concept:sportsgamesport	concept-sport-soccer
concept-sportsgame-n2002-world-cup	concept:sportsgamesport	concept-sport-soccer
concept-sportsgame-n2005-u-s--open	concept:sportsgamesport	concept-sport-tennis
concept-sportsleague-field	concept:agentinvolvedwithitem	concept-buildingfeature-window
concept-sportsleague-mls	concept:organizationacronymhasname	concept-sportsleague-major-league-soccer
concept-sportsleague-rss	concept:agentcompeteswithagent	concept-university-search
concept-sportsteam-chicago-fire	concept:teamplayssport	concept-sport-soccer
concept-sportsteam-chivas	concept:subpartoforganization	concept-sportsleague-mls
concept-sportsteam-chivas-usa	concept:teamplaysagainstteam	concept-sportsteam-real-salt-lake
concept-sportsteam-colorado-rapids	concept:teamplaysinleague	concept-sportsleague-mls
concept-sportsteam-columbus-crew	concept:teamplaysinleague	concept-sportsleague-mls
concept-sportsteam-d-c--united	concept:teamplaysinleague	concept-sportsleague-mls
concept-sportsteam-fc-dallas	concept:teamplaysinleague	concept-sportsleague-mls
concept-sportsteam-houston-dynamo	concept:teamplaysinleague	concept-sportsleague-mls
concept-sportsteam-kansas-city-wizards	concept:teamplaysinleague	concept-sportsleague-mls
concept-sportsteam-los-angeles-galaxy	concept:teamplaysinleague	concept-sportsleague-mls
concept-sportsteam-minnesota-lynx	concept:teamhomestadium	concept-stadiumoreventvenue-target-center
concept-sportsteam-new-england-revolution	concept:teamplaysinleague	concept-sportsleague-mls
concept-sportsteam-new-york-red-bulls	concept:teamplaysincity	concept-city-east-rutherford
concept-sportsteam-new-york-red-bulls	concept:teamplaysinleague	concept-sportsleague-mls
concept-sportsteam-ny-red-bulls	concept:agentbelongstoorganization	concept-sportsleague-mls
concept-sportsteam-real-salt-lake	concept:teamplaysinleague	concept-sportsleague-mls
concept-sportsteam-red-bull-new-york	concept:agentbelongstoorganization	concept-sportsleague-mls
concept-sportsteam-san-jose-earthquakes	concept:teamplaysinleague	concept-sportsleague-mls
concept-sportsteam-seattle-sounders-fc	concept:teamplaysinleague	concept-sportsleague-mls
concept-sportsteam-sporting-kansas-city	concept:teamplaysinleague	concept-sportsleague-mls
concept-sportsteam-toronto-fc	concept:teamplaysinleague	concept-sportsleague-mls
concept-sportsteam-vancouver-whitecaps	concept:subpartoforganization	concept-sportsleague-mls
concept-sportsteam-western-washington-university	concept:teamplaysincity	concept-city-bellingham
concept-stadiumoreventvenue-target-center	concept:stadiumlocatedincity	concept-city-minneapolis
concept-stateorprovince-bayelsa	concept:statelocatedincountry	concept-country-nigeria
concept-stateorprovince-bolivar	concept:proxyfor	concept-company-missouri
concept-stateorprovince-connecticut	concept:mutualproxyfor	concept-city-bridgeport
concept-stateorprovince-facility	concept:subpartoforganization	concept-terroristorganization-state
concept-stateorprovince-florida	concept:statelocatedingeopoliticallocation	concept-country-tanzania
concept-stateorprovince-kentucky	concept:stateorprovinceisborderedbystateorprovince	concept-stateorprovince-west-virginia
concept-stateorprovince-maryland	concept:mutualproxyfor	concept-mountain-columbia
concept-stateorprovince-ohio	concept:statehascapital	concept-city-columbus
concept-stateorprovince-ontario	concept:statehascapital	concept-city-glencoe
concept-stateorprovince-store	concept:agentinvolvedwithitem	concept-buildingfeature-window
concept-stateorprovince-virginia	concept:atdate	concept-date-n1864
concept-stateorprovince-virginia	concept:atdate	concept-year-n1781
concept-stateorprovince-virginia	concept:atdate	concept-year-n1865
concept-stateorprovince-virginia	concept:mutualproxyfor	concept-city-charlottesville
concept-stateorprovince-virginia	concept:mutualproxyfor	concept-city-fredericksburg
concept-stateorprovince-virginia	concept:mutualproxyfor	concept-city-herndon
concept-stateorprovince-virginia	concept:mutualproxyfor	concept-city-newport-news-hampton-wmsburg
concept-stateorprovince-virginia	concept:mutualproxyfor	concept-city-sterling
concept-stateorprovince-virginia	concept:mutualproxyfor	concept-county-lexington
concept-stateorprovince-virginia	concept:mutualproxyfor	concept-county-williamsburg
concept-stateorprovince-west-virginia	concept:mutualproxyfor	concept-city-morgantown
concept-stateorprovince-west-virginia	concept:organizationhiredperson	concept-person-rodriguez
concept-stateorprovince-west-virginia	concept:stateorprovinceisborderedbystateorprovince	concept-stateorprovince-ohio
concept-televisionshow-aug-	concept:atdate	concept-date-community
concept-televisionshow-last-friday	concept:atdate	concept-date-community
concept-televisionshow-last-monday	concept:atdate	concept-date-community
concept-televisionshow-last-saturday	concept:atdate	concept-date-community
concept-televisionshow-last-sunday	concept:atdate	concept-date-community
concept-televisionshow-last-thursday	concept:atdate	concept-date-community
concept-televisionshow-last-wednesday	concept:atdate	concept-date-community
concept-televisionshow-monday	concept:atdate	concept-date-community
concept-televisionshow-monday-morning	concept:atdate	concept-date-community
concept-televisionshow-one-friday	concept:atdate	concept-date-community
concept-televisionshow-p-m--tuesday	concept:atdate	concept-date-community
concept-televisionshow-pearl-harbor	concept:atdate	concept-date-n1941
concept-televisionshow-saturday	concept:atdate	concept-date-community
concept-televisionshow-tuesday	concept:atdate	concept-date-community
concept-televisionshow-wednesday	concept:atdate	concept-date-community
concept-televisionshow-wednesday-morning	concept:atdate	concept-date-community
concept-televisionstation-google-maps	concept:agentinvolvedwithitem	concept-buildingfeature-window
concept-televisionstation-kaid	concept:agentbelongstoorganization	concept-company-pbs
concept-televisionstation-kare11	concept:televisionstationincity	concept-city-minneapolis
concept-televisionstation-kcfw-tv	concept:subpartof	concept-retailstore-nbc
concept-televisionstation-kcpt	concept:agentbelongstoorganization	concept-company-pbs
concept-televisionstation-kcts	concept:organizationheadquarteredincity	concept-city-seattle
concept-televisionstation-keci	concept:subpartof	concept-retailstore-nbc
concept-televisionstation-kepb	concept:televisionstationaffiliatedwith	concept-televisionnetwork-pbs
concept-televisionstation-keta-tv	concept:televisionstationaffiliatedwith	concept-televisionnetwork-pbs
concept-televisionstation-kfme	concept:subpartoforganization	concept-televisionnetwork-pbs
concept-televisionstation-khq--tv	concept:subpartof	concept-retailstore-nbc
concept-televisionstation-kiem-tv	concept:subpartof	concept-retailstore-nbc
concept-televisionstation-kjre	concept:televisionstationaffiliatedwith	concept-televisionnetwork-pbs
concept-televisionstation-kjrh	concept:subpartof	concept-retailstore-nbc
concept-televisionstation-kkco	concept:subpartof	concept-retailstore-nbc
concept-televisionstation-klcs-tv	concept:televisionstationaffiliatedwith	concept-televisionnetwork-pbs
concept-televisionstation-klru-tv	concept:televisionstationaffiliatedwith	concept-televisionnetwork-pbs
concept-televisionstation-kmtr	concept:subpartof	concept-retailstore-nbc
concept-televisionstation-knaz-tv	concept:subpartof	concept-retailstore-nbc
concept-televisionstation-kndu	concept:subpartof	concept-retailstore-nbc
concept-televisionstation-koce-tv	concept:televisionstationaffiliatedwith	concept-televisionnetwork-pbs
concept-televisionstation-koed-tv	concept:agentbelongstoorganization	concept-company-pbs
concept-televisionstation-kozj-tv	concept:televisionstationaffiliatedwith	concept-televisionnetwork-pbs
concept-televisionstation-kpts-tv	concept:televisionstationaffiliatedwith	concept-televisionnetwork-pbs
concept-televisionstation-kqed	concept:televisionstationaffiliatedwith	concept-televisionnetwork-pbs
concept-televisionstation-krmz	concept:televisionstationaffiliatedwith	concept-televisionnetwork-pbs
concept-televisionstation-kshb-tv	concept:subpartof	concept-retailstore-nbc
concept-televisionstation-ksnt	concept:subpartof	concept-retailstore-nbc
concept-televisionstation-ktvm	concept:subpartof	concept-retailstore-nbc
concept-televisionstation-kusa-tv	concept:subpartof	concept-retailstore-nbc
concept-televisionstation-kvie	concept:agentbelongstoorganization	concept-company-pbs
concept-televisionstation-kvie	concept:televisionstationaffiliatedwith	concept-televisionnetwork-pbs
concept-televisionstation-kvie	concept:televisionstationincity	concept-city-sacramento
concept-televisionstation-kwes	concept:subpartof	concept-retailstore-nbc
concept-televisionstation-kyma	concept:subpartof	concept-retailstore-nbc
concept-televisionstation-kytv	concept:subpartof	concept-retailstore-nbc
concept-televisionstation-kytv	concept:subpartoforganization	concept-televisionnetwork-nbc-universal
concept-televisionstation-wabw-tv	concept:televisionstationaffiliatedwith	concept-televisionnetwork-pbs
concept-televisionstation-waff	concept:subpartof	concept-retailstore-nbc
concept-televisionstation-waff	concept:televisionstationincity	concept-city-huntsville
concept-televisionstation-wcbb-tv	concept:televisionstationaffiliatedwith	concept-televisionnetwork-pbs
concept-televisionstation-wces-tv	concept:televisionstationaffiliatedwith	concept-televisionnetwork-pbs
concept-televisionstation-wceu	concept:televisionstationaffiliatedwith	concept-televisionnetwork-pbs
concept-televisionstation-wciq	concept:televisionstationaffiliatedwith	concept-televisionnetwork-pbs
concept-televisionstation-wcnc-tv	concept:subpartof	concept-retailstore-nbc
concept-televisionstation-wcte	concept:televisionstationaffiliatedwith	concept-televisionnetwork-pbs
concept-televisionstation-wcvw	concept:televisionstationaffiliatedwith	concept-televisionnetwork-pbs
concept-televisionstation-wdsc-tv	concept:televisionstationaffiliatedwith	concept-televisionnetwork-pbs
concept-televisionstation-wedh	concept:televisionstationaffiliatedwith	concept-televisionnetwork-pbs
concept-televisionstation-wfum	concept:subpartoforganization	concept-televisionnetwork-pbs
concept-televisionstation-whyy	concept:agentbelongstoorganization	concept-company-pbs
concept-televisionstation-wicd	concept:subpartof	concept-retailstore-nbc
concept-televisionstation-wicu-tv	concept:subpartof	concept-retailstore-nbc
concept-televisionstation-will-tv	concept:televisionstationaffiliatedwith	concept-televisionnetwork-pbs
concept-televisionstation-wjwj-tv	concept:televisionstationaffiliatedwith	concept-televisionnetwork-pbs
concept-televisionstation-wkle-tv	concept:televisionstationaffiliatedwith	concept-televisionnetwork-pbs
concept-televisionstation-wltz	concept:subpartof	concept-retailstore-nbc
concept-televisionstation-wmum-tv	concept:agentbelongstoorganization	concept-company-pbs
concept-televisionstation-wnet	concept:televisionstationaffiliatedwith	concept-televisionnetwork-pbs
concept-televisionstation-wnky	concept:subpartof	concept-retailstore-nbc
concept-televisionstation-wnyt-tv	concept:subpartof	concept-retailstore-nbc
concept-televisionstation-wpbn-tv	concept:subpartof	concept-retailstore-nbc
concept-televisionstation-wpne	concept:subpartoforganization	concept-televisionnetwork-pbs
concept-televisionstation-wpxi-tv	concept:subpartof	concept-retailstore-nbc
concept-televisionstation-wqln	concept:subpartoforganization	concept-televisionnetwork-pbs
concept-televisionstation-wtci	concept:agentbelongstoorganization	concept-company-pbs
concept-televisionstation-wtvs	concept:televisionstationaffiliatedwith	concept-televisionnetwork-pbs
concept-televisionstation-wtwc-tv	concept:subpartof	concept-retailstore-nbc
concept-televisionstation-wvan-tv	concept:televisionstationaffiliatedwith	concept-televisionnetwork-pbs
concept-televisionstation-wvia-tv	concept:televisionstationaffiliatedwith	concept-televisionnetwork-pbs
concept-televisionstation-wvla	concept:subpartof	concept-retailstore-nbc
concept-televisionstation-wvpy-tv	concept:televisionstationaffiliatedwith	concept-televisionnetwork-pbs
concept-televisionstation-wvtm-tv	concept:subpartof	concept-retailstore-nbc
concept-terroristorganization-command	concept:agentinvolvedwithitem	concept-buildingfeature-window
concept-terroristorganization-state	concept:agentactsinlocation	concept-city-azerbaijan
concept-terroristorganization-state	concept:agentcontrols	concept-buildingfeature-systems
concept-terroristorganization-state	concept:agentcontrols	concept-mlalgorithm-solutions
concept-terroristorganization-state	concept:agentcontrols	concept-museum-technologies
concept-terroristorganization-state	concept:agentcontrols	concept-politicsissue-processes
concept-terroristorganization-state	concept:agentcontrols	concept-politicsissue-requirements
concept-terroristorganization-state	concept:agentcontrols	concept-profession-agency-personnel
concept-terroristorganization-state	concept:agentcontrols	concept-profession-practitioners
concept-terroristorganization-state	concept:agentcontrols	concept-programminglanguage-procedures
concept-terroristorganization-state	concept:agentcontrols	concept-programminglanguage-process
concept-terroristorganization-state	concept:agentcontrols	concept-programminglanguage-services
concept-terroristorganization-state	concept:agentcontrols	concept-sport-initiatives
concept-terroristorganization-state	concept:agentcontrols	concept-sportsgame-leaders
concept-terroristorganization-state	concept:agentcontrols	concept-televisionshow-confederate-money
concept-terroristorganization-state	concept:agentcontrols	concept-website-partners
concept-terroristorganization-state	concept:organizationhiredperson	concept-coach-chuck-amato
concept-terroristorganization-state	concept:organizationhiredperson	concept-coach-kay-yow
concept-tradeunion-agreement	concept:agentbelongstoorganization	concept-terroristorganization-state
concept-tradeunion-article	concept:agentcompeteswithagent	concept-country-democratic-republic-of-congo
concept-transportation-start	concept:objectfoundinscene	concept-landscapefeatures-valley
concept-university-kansas-city	concept:proxyfor	concept-company-missouri
concept-university-kentucky	concept:atdate	concept-year-n1865
concept-university-message	concept:agentinvolvedwithitem	concept-buildingfeature-window
concept-university-microsoft	concept:agentcollaborateswithagent	concept-ceo-steve-ballmer
concept-university-microsoft	concept:agentcollaborateswithagent	concept-company-gates
concept-university-microsoft	concept:agentcollaborateswithagent	concept-personus-steve-ballmer
concept-university-microsoft	concept:agentcontrols	concept-website-bill
concept-university-microsoft	concept:agentcreated	concept-buildingfeature-windows
concept-university-microsoft	concept:agentcreated	concept-charactertrait-vista
concept-university-microsoft	concept:agentinvolvedwithitem	concept-vehicle-express
concept-university-microsoft	concept:agentinvolvedwithitem	concept-vehicle-visual-studio
concept-university-microsoft	concept:organizationterminatedperson	concept-scientist-balmer
concept-university-microsoft	concept:synonymfor	concept-software-excel-2007
concept-university-norway	concept:atdate	concept-date-n1941
concept-university-search	concept:agentcompeteswithagent	concept-biotechcompany-marketing
concept-university-search	concept:agentcompeteswithagent	concept-blog-access
concept-university-search	concept:agentcompeteswithagent	concept-blog-metadata
concept-university-search	concept:agentcompeteswithagent	concept-company-askjeeves
concept-university-search	concept:agentcompeteswithagent	concept-company-focus
concept-university-search	concept:agentcompeteswithagent	concept-company-power
concept-university-search	concept:agentcompeteswithagent	concept-company-rank
concept-university-search	concept:agentcompeteswithagent	concept-company-yahoo--local
concept-university-search	concept:agentcompeteswithagent	concept-televisionstation-traffic
concept-university-search	concept:agentcompeteswithagent	concept-website-clusty
concept-university-search	concept:agentcompeteswithagent	concept-website-dmoz
concept-university-search	concept:agentcompeteswithagent	concept-website-dogpile
concept-university-search	concept:agentcompeteswithagent	concept-website-gigablast
concept-university-search	concept:agentcompeteswithagent	concept-website-google--com
concept-university-search	concept:agentcompeteswithagent	concept-website-google-search
concept-university-search	concept:agentcompeteswithagent	concept-website-google-yahoo
concept-university-search	concept:agentcompeteswithagent	concept-website-googletm
concept-university-search	concept:agentcompeteswithagent	concept-website-yahoo--search-marketing
concept-vegetable-carrot	concept:agriculturalproductcutintogeometricshape	concept-geometricshape-cubes
concept-vegetable-carrots	concept:agriculturalproductcutintogeometricshape	concept-geometricshape-cubes
concept-vegetable-celery	concept:agriculturalproductcutintogeometricshape	concept-geometricshape-cubes
concept-vegetable-garlic	concept:agriculturalproductcutintogeometricshape	concept-geometricshape-cubes
concept-vegetable-ginger	concept:agriculturalproductcutintogeometricshape	concept-geometricshape-cubes
concept-vegetable-potato	concept:agriculturalproductcutintogeometricshape	concept-geometricshape-cubes
concept-vehicle-regions	concept:objectfoundinscene	concept-landscapefeatures-valley
concept-videogame-western-front	concept:atdate	concept-date-n1944
concept-virus-hostilities	concept:atdate	concept-date-n1941
concept-visualartist-games	concept:agentinvolvedwithitem	concept-buildingfeature-window
concept-visualartist-robert	concept:persondiedatage	2
concept-visualizableobject-foot	concept:objectfoundinscene	concept-landscapefeatures-valley
concept-visualizableobject-head001	concept:objectfoundinscene	concept-landscapefeatures-valley
concept-visualizableobject-map	concept:objectfoundinscene	concept-landscapefeatures-valley
concept-visualizableobject-picture	concept:objectfoundinscene	concept-landscapefeatures-valley
concept-visualizableobject-region	concept:objectfoundinscene	concept-landscapefeatures-valley
concept-visualizableobject-shirt	concept:clothingtogowithclothing	concept-clothing-apron
concept-visualizableobject-shirt	concept:clothingtogowithclothing	concept-clothing-bathing-suit
concept-visualizableobject-shirt	concept:clothingtogowithclothing	concept-clothing-black-suit
concept-visualizableobject-shirt	concept:clothingtogowithclothing	concept-clothing-breeches
concept-visualizableobject-shirt	concept:clothingtogowithclothing	concept-clothing-cords
concept-visualizableobject-shirt	concept:clothingtogowithclothing	concept-clothing-cotton
concept-visualizableobject-shirt	concept:clothingtogowithclothing	concept-clothing-coveralls
concept-visualizableobject-shirt	concept:clothingtogowithclothing	concept-clothing-cowboy-boots
concept-visualizableobject-shirt	concept:clothingtogowithclothing	concept-clothing-cowboy-hat
concept-visualizableobject-shirt	concept:clothingtogowithclothing	concept-clothing-dark-suit
concept-visualizableobject-shirt	concept:clothingtogowithclothing	concept-clothing-golf-shirt
concept-visualizableobject-shirt	concept:clothingtogowithclothing	concept-clothing-green-pants
concept-visualizableobject-shirt	concept:clothingtogowithclothing	concept-clothing-light-jacket
concept-visualizableobject-shirt	concept:clothingtogowithclothing	concept-clothing-long-sleeved-shirt
concept-visualizableobject-shirt	concept:clothingtogowithclothing	concept-clothing-mask
concept-visualizableobject-shirt	concept:clothingtogowithclothing	concept-clothing-short-sleeve
concept-visualizableobject-shirt	concept:clothingtogowithclothing	concept-clothing-striped-pants
concept-visualizableobject-shirt	concept:clothingtogowithclothing	concept-clothing-sun-hat
concept-visualizableobject-shirt	concept:clothingtogowithclothing	concept-clothing-t-shirt
concept-visualizableobject-shirt	concept:clothingtogowithclothing	concept-clothing-tight-jeans
concept-visualizableobject-shirt	concept:clothingtogowithclothing	concept-clothing-tights
concept-visualizableobject-shirt	concept:clothingtogowithclothing	concept-clothing-tuxedo
concept-visualizableobject-shirt	concept:clothingtogowithclothing	concept-clothing-white-pants
concept-visualizableobject-shirt	concept:clothingtogowithclothing	concept-clothing-windbreaker
concept-visualizableobject-shirt	concept:clothingtogowithclothing	concept-clothing-work-trousers
concept-visualizableobject-tip	concept:objectfoundinscene	concept-landscapefeatures-valley
concept-visualizableobject-top	concept:objectfoundinscene	concept-landscapefeatures-valley
concept-visualizablescene-north-bay	concept:proxyfor	concept-stateorprovince-ontario
concept-visualizablething-bedrooms	concept:subpartof	concept-weatherphenomenon-air
concept-visualizablething-front	concept:atdate	concept-date-n1944
concept-visualizablething-polenta	concept:agriculturalproductcutintogeometricshape	concept-geometricshape-squares
concept-wallitem-beginning	concept:subpartof	concept-hallwayitem-air
concept-wallitem-instrument	concept:subpartof	concept-hallwayitem-air
concept-wallitem-works	concept:subpartof	concept-hallwayitem-air
concept-weapon-arms	concept:weaponmadeincountry	concept-country-venezuela
concept-weapon-automatic-guns	concept:weaponssuchasweapons	concept-weapon-nuclear-missile
concept-weapon-average-gas	concept:weaponssuchasweapons	concept-weapon-nuclear-missile
concept-weapon-blowguns	concept:weaponssuchasweapons	concept-weapon-nuclear-missile
concept-weapon-bomb	concept:weaponmadeincountry	concept-country---america
concept-weapon-border	concept:objectfoundinscene	concept-landscapefeatures-valley
concept-weapon-boxed-collectible-knives	concept:weaponssuchasweapons	concept-weapon-nuclear-missile
concept-weapon-case	concept:objectfoundinscene	concept-landscapefeatures-valley
concept-weapon-cluster-munition	concept:weaponssuchasweapons	concept-weapon-nuclear-missile
concept-weapon-cozy-gas	concept:weaponssuchasweapons	concept-weapon-nuclear-missile
concept-weapon-current-gas	concept:weaponssuchasweapons	concept-weapon-nuclear-missile
concept-weapon-deck-guns	concept:weaponssuchasweapons	concept-weapon-nuclear-missile
concept-weapon-desert-eagle	concept:weaponssuchasweapons	concept-weapon-nuclear-missile
concept-weapon-diver-s-knives	concept:weaponssuchasweapons	concept-weapon-nuclear-missile
concept-weapon-efficient-natural-gas	concept:weaponssuchasweapons	concept-weapon-nuclear-missile
concept-weapon-energy-swords	concept:weaponssuchasweapons	concept-weapon-nuclear-missile
concept-weapon-equipment	concept:weaponmadeincountry	concept-country-iran
concept-weapon-equipment	concept:weaponssuchasweapons	concept-weapon-nuclear-missile
concept-weapon-fdt-knives	concept:weaponssuchasweapons	concept-weapon-nuclear-missile
concept-weapon-flak-cannon	concept:weaponssuchasweapons	concept-weapon-nuclear-missile
concept-weapon-fusion-cutter	concept:weaponssuchasweapons	concept-weapon-nuclear-missile
concept-weapon-future-coal	concept:weaponssuchasweapons	concept-weapon-nuclear-missile
concept-weapon-gas-canisters	concept:weaponssuchasweapons	concept-weapon-nuclear-missile
concept-weapon-highlander-sword	concept:weaponssuchasweapons	concept-weapon-nuclear-missile
concept-weapon-large-gas	concept:weaponssuchasweapons	concept-weapon-nuclear-missile
concept-weapon-larger-weapons	concept:weaponssuchasweapons	concept-weapon-nuclear-missile
concept-weapon-laser-cannons	concept:weaponssuchasweapons	concept-weapon-nuclear-missile
concept-weapon-laser-pistol	concept:weaponssuchasweapons	concept-weapon-nuclear-missile
concept-weapon-level	concept:objectfoundinscene	concept-landscapefeatures-valley
concept-weapon-local-natural-gas	concept:weaponssuchasweapons	concept-weapon-nuclear-missile
concept-weapon-many-gas	concept:weaponssuchasweapons	concept-weapon-nuclear-missile
concept-weapon-missile	concept:weaponmadeincountry	concept-country-azerbaijan
concept-weapon-n2-rifle	concept:weaponssuchasweapons	concept-weapon-nuclear-missile
concept-weapon-nazi-germany	concept:atdate	concept-date-n1941
concept-weapon-part	concept:objectfoundinscene	concept-landscapefeatures-valley
concept-weapon-pirates-sword	concept:weaponssuchasweapons	concept-weapon-nuclear-missile
concept-weapon-sentry-guns	concept:weaponssuchasweapons	concept-weapon-nuclear-missile
concept-weapon-sharp-sword	concept:weaponssuchasweapons	concept-weapon-nuclear-missile
concept-weapon-short-range-ballistic-missile	concept:weaponssuchasweapons	concept-weapon-nuclear-missile
concept-weapon-sights	concept:objectfoundinscene	concept-landscapefeatures-valley
concept-weapon-sks-rifle	concept:weaponssuchasweapons	concept-weapon-nuclear-missile
concept-weapon-smartlock-pistols	concept:weaponssuchasweapons	concept-weapon-nuclear-missile
concept-weapon-soviet-union	concept:atdate	concept-date-n1941
concept-weapon-stick-swords	concept:weaponssuchasweapons	concept-weapon-nuclear-missile
concept-weapon-sub-machineguns	concept:weaponssuchasweapons	concept-weapon-nuclear-missile
concept-weapon-taepodong-missile	concept:weaponssuchasweapons	concept-weapon-nuclear-missile
concept-weapon-twin-missile	concept:weaponssuchasweapons	concept-weapon-nuclear-missile
concept-weapon-two-new-coal	concept:weaponssuchasweapons	concept-weapon-nuclear-missile
concept-weapon-two-rocket	concept:weaponssuchasweapons	concept-weapon-nuclear-missile
concept-weapon-united-states-navy	concept:atdate	concept-date-n1941
concept-weapon-warheads	concept:weaponmadeincountry	concept-country-scandinavian-countries
concept-weapon-weapons	concept:weaponmadeincountry	concept-country-sinai
concept-weapon-weapons	concept:weaponmadeincountry	concept-country-venezuela
concept-weapon-weapons-agents	concept:weaponssuchasweapons	concept-weapon-nuclear-missile
concept-weapon-winchesters	concept:weaponssuchasweapons	concept-weapon-nuclear-missile
concept-weapon-yellowcake-uranium	concept:weaponssuchasweapons	concept-weapon-nuclear-missile
concept-weatherphenomenon-pacific	concept:atdate	concept-date-n1944
concept-website-amazon	concept:headquarteredin	concept-city-seattle
concept-website-aol-search	concept:agentcompeteswithagent	concept-university-search
concept-website-google-images	concept:agentcompeteswithagent	concept-university-search
concept-website-inktomi	concept:subpartoforganization	concept-website-yahoo-mail
concept-website-ksby	concept:subpartof	concept-retailstore-nbc
concept-website-ksee	concept:subpartof	concept-retailstore-nbc
concept-website-ktal-tv	concept:subpartof	concept-retailstore-nbc
concept-website-kwwl	concept:subpartof	concept-retailstore-nbc
concept-website-kxas-tv	concept:subpartof	concept-retailstore-nbc
concept-website-wcau	concept:subpartof	concept-retailstore-nbc
concept-website-witn-tv	concept:subpartof	concept-retailstore-nbc
concept-website-wpmi	concept:subpartof	concept-retailstore-nbc
concept-website-wwlp	concept:subpartof	concept-retailstore-nbc
concept-winery-kirkwood	concept:proxyfor	concept-company-missouri
concept-writer-profile	concept:agentinvolvedwithitem	concept-buildingfeature-window
concept-writer-walker	concept:personborninlocation	concept-county-york-city
concept-year-new	concept:atlocation	concept-attraction-louisiana
concept-year-new	concept:atlocation	concept-hospital-system
concept-year-new	concept:atlocation	concept-skiarea-case
concept-year-new	concept:atlocation	concept-stateorprovince-act
concept-year-new	concept:atlocation	concept-stateorprovince-man
concept-year-new	concept:atlocation	concept-stateorprovince-state-capital
concept-year-new	concept:atlocation	concept-visualizablething-parishes
concept-year-new	concept:atlocation	concept-zoo-moment
concept-year-new	concept:mutualproxyfor	concept-city-bar
concept-year-new	concept:mutualproxyfor	concept-city-children
concept-year-new	concept:mutualproxyfor	concept-city-princeton
concept-year-new	concept:mutualproxyfor	concept-city-seat
concept-year-new	concept:mutualproxyfor	concept-county-bedford
concept-year-new	concept:mutualproxyfor	concept-county-families
concept-year-new	concept:mutualproxyfor	concept-geopoliticallocation-option
concept-year-new	concept:mutualproxyfor	concept-geopoliticallocation-u-s--state
concept-year-new	concept:mutualproxyfor	concept-geopoliticalorganization-bottom
concept-year-new	concept:mutualproxyfor	concept-mountain-inspiration
concept-year-new	concept:mutualproxyfor	concept-mountainrange-hudson-valley
concept-year-new	concept:mutualproxyfor	concept-musicsong-moments
concept-year-new	concept:mutualproxyfor	concept-musicsong-oklahoma
concept-year-new	concept:mutualproxyfor	concept-musicsong-two-weeks
concept-year-new	concept:mutualproxyfor	concept-newspaper-destinations
concept-year-new	concept:mutualproxyfor	concept-newspaper-winner
concept-year-new	concept:mutualproxyfor	concept-politicianus-small-town
concept-year-new	concept:mutualproxyfor	concept-politicsissue-opportunity
concept-year-new	concept:mutualproxyfor	concept-politicsissue-responsibility
concept-year-new	concept:mutualproxyfor	concept-recordlabel-priority
concept-year-new	concept:mutualproxyfor	concept-retailstore-times-square
concept-year-new	concept:mutualproxyfor	concept-skiarea-combination
concept-year-new	concept:mutualproxyfor	concept-sportsteam-hampshire
concept-year-new	concept:mutualproxyfor	concept-stateorprovince-virginia
concept-year-new	concept:mutualproxyfor	concept-stateorprovince-woman
concept-year-new	concept:mutualproxyfor	concept-university-search
concept-year-new	concept:mutualproxyfor	concept-university-vermont
concept-year-new	concept:mutualproxyfor	concept-visualizablescene-birthplace
concept-year-new	concept:proxyfor	concept-bank-attorneys
concept-year-new	concept:proxyfor	concept-bank-lawyer
concept-year-new	concept:proxyfor	concept-university-attorney
concept-year-new	concept:proxyfor	concept-university-reasons
concept-year-new	concept:proxyfor	concept-visualizablething-thousand-years
concept-year-new	concept:proxyfor	concept-visualizablething-weekends
concept-year-new	concept:subpartof	concept-stateorprovince-miles
concept-televisionstation-wnin-tv	concept:subpartoforganization	concept-televisionnetwork-pbs
concept-company-pbs	concept:agentcontrols	concept-televisionstation-kvie
concept-televisionstation-wbcc-tv	concept:agentbelongstoorganization	concept-company-pbs
concept-sport-first-golf	concept:sportfansincountry	concept-country---america
concept-athlete-jason	concept:athleteinjuredhisbodypart	concept-bone-shoulder
concept-televisionstation-wkyu-tv	concept:subpartof	concept-company-pbs
concept-river-yazoo-river	concept:riveremptiesintoriver	concept-river-mississippi-river
concept-city-columbia	concept:proxyfor	concept-stateorprovince-maryland
concept-country-zimbabwe	concept:countryalsoknownas	concept-country-republic
concept-personus-steve-ballmer	concept:worksfor	concept-university-microsoft
concept-sport-volleyball	concept:sportusesequipment	concept-sportsequipment-area
concept-company-user	concept:agentinvolvedwithitem	concept-buildingfeature-windows
concept-automobilemaker-subaru	concept:producesproduct	concept-automobilemodel-subaru-forester
concept-televisionstation-kswk	concept:televisionstationaffiliatedwith	concept-televisionnetwork-pbs
concept-politicianus-mikhail-gorbachev	concept:personbelongstoorganization	concept-organization-soviet
concept-athlete-frank	concept:athleteinjuredhisbodypart	concept-braintissue-eyes
concept-weapon-course	concept:objectfoundinscene	concept-landscapefeatures-valley
concept-televisionstation-kbme-tv	concept:agentcollaborateswithagent	concept-company-pbs
concept-politician-sites	concept:agentinvolvedwithitem	concept-buildingfeature-window
concept-sport-bowling	concept:sportusesequipment	concept-sportsequipment-bag
concept-televisionstation-wosu-tv	concept:televisionstationaffiliatedwith	concept-televisionnetwork-pbs
concept-personaustralia-michael	concept:athleteinjuredhisbodypart	concept-braintissue-eyes
concept-city-district	concept:cityalsoknownas	concept-city-columbia
concept-month-march	concept:atdate	concept-date-meeting
concept-clothing-white-shirt	concept:clothingtogowithclothing	concept-clothing-tie
concept-clothing-tee	concept:clothingtogowithclothing	concept-clothing-skirt
concept-televisionstation-wosu-tv	concept:agentcollaborateswithagent	concept-company-pbs
concept-athlete-kevin	concept:persondiedatage	2
concept-automobilemaker-subaru	concept:producesproduct	concept-automobilemodel-wrx
concept-city-chantilly	concept:locationlocatedwithinlocation	concept-stateorprovince-virginia
concept-company-yahoo001	concept:agentinvolvedwithitem	concept-buildingfeature-window
concept-bank-citibank	concept:companyeconomicsector	concept-economicsector-investment
concept-sport-billiard	concept:sportusesequipment	concept-sportsequipment-balls
concept-sport-boating	concept:sportusesequipment	concept-sportsequipment-gear
concept-athlete-curtis-martin	concept:athletehomestadium	concept-stadiumoreventvenue-giants-stadium
concept-televisionstation-kusm	concept:subpartof	concept-company-pbs
concept-clothing-socks	concept:clothingtogowithclothing	concept-clothing-trousers
concept-athlete-o--j--simpson	concept:athleteplayssportsteamposition	concept-sportsteamposition-running-back
concept-fish-billfish	concept:animalsuchasfish	concept-fish-pelagics
concept-automobilemaker-chevrolet	concept:automobilemakercardealersinstateorprovince	concept-stateorprovince-virginia
concept-televisionstation-kbme-tv	concept:agentbelongstoorganization	concept-company-pbs
concept-country-darfur-region	concept:countryalsoknownas	concept-country-republic
concept-city-army	concept:atdate	concept-date-n1944
concept-city-cambridge	concept:cityliesonriver	concept-attraction-grand
concept-musicartist-session	concept:atdate	concept-date-feb-
concept-automobilemaker-ford	concept:competeswith	concept-automobilemaker-chrysler
concept-televisionstation-wkso-tv	concept:agentcollaborateswithagent	concept-company-pbs
concept-organization-lehman	concept:companyeconomicsector	concept-economicsector-investment
concept-country-gabon	concept:countryalsoknownas	concept-country-republic
concept-sport-diving	concept:sportusesequipment	concept-sportsequipment-equipment
concept-sport-sports	concept:sportusesequipment	concept-sportsequipment-football
concept-country-republic-of-lithuania	concept:synonymfor	concept-politicalparty-republic
concept-televisionstation-wqec	concept:televisionstationaffiliatedwith	concept-televisionnetwork-pbs
concept-city-morgantown	concept:citylocatedinstate	concept-stateorprovince-west-virginia
concept-clothing-trousers	concept:clothingtogowithclothing	concept-clothing-tie
concept-organization-lehman	concept:organizationacronymhasname	concept-bank-lehman-brothers
concept-televisionstation-whyy	concept:televisionstationaffiliatedwith	concept-televisionnetwork-pbs
concept-country-slovak-republic	concept:countrylocatedingeopoliticallocation	concept-country-countries
concept-clothing-skirt	concept:clothingtogowithclothing	concept-clothing-heels
concept-sport-sports	concept:sportusesequipment	concept-sportsequipment-ball
concept-person-michael002	concept:personmovedtostateorprovince	concept-stateorprovince-virginia
concept-clothing-shirts	concept:clothingtogowithclothing	concept-clothing-sweat-pants
concept-country-somalia	concept:countrylocatedingeopoliticallocation	concept-continent-africa
concept-televisionstation-krne-tv	concept:agentcollaborateswithagent	concept-company-pbs
concept-sport-sports	concept:sportfansincountry	concept-country-ireland
concept-city-tokyo	concept:atdate	concept-year-n1946
concept-televisionstation-kued	concept:agentcollaborateswithagent	concept-company-pbs
concept-bank-national	concept:bankbankincountry	concept-country-cayman-islands
concept-athlete-kevin	concept:athleteinjuredhisbodypart	concept-bodypart-hands
concept-clothing-shirts	concept:clothingtogowithclothing	concept-clothing-long-pants
concept-year-new	concept:proxyfor	concept-stateorprovince-miles
concept-country-poland	concept:countrylocatedingeopoliticallocation	concept-geopoliticallocation-destinations
concept-athlete-wallace	concept:athleteinjuredhisbodypart	concept-braintissue-eyes
concept-automobilemaker-ford	concept:producesproduct	concept-automobilemodel-ford-mustang
concept-university-microsoft	concept:agentcreated	concept-product-powerpoint
concept-nongovorganization-u-s--navy	concept:atdate	concept-date-n1942
concept-company-gates	concept:agentcontrols	concept-university-microsoft
